"ReportDate","Year","LvCitizens","LvNonCitizens","LvAlternative","LvStateless","LvRefugee","LvTemporary","Foreign","Total"
2007-01-01,2006,20643,909,0,0,0,0,72,21624
2007-01-01,2005,20758,844,0,1,0,0,167,21770
2007-01-01,2004,19388,861,0,0,0,0,177,20426
2007-01-01,2003,19893,879,0,0,0,0,129,20901
2007-01-01,2002,18860,909,0,1,0,0,155,19925
2007-01-01,2001,18318,923,0,1,0,0,181,19423
2007-01-01,2000,18730,1076,0,1,0,0,172,19979
2007-01-01,1999,17857,976,0,0,0,0,230,19063
2007-01-01,1998,16829,960,0,0,0,0,219,18008
2007-01-01,1997,17147,1003,0,1,0,0,228,18379
2007-01-01,1996,17885,1112,0,0,0,0,221,19218
2007-01-01,1995,19506,1214,0,0,0,0,241,20961
2007-01-01,1994,21444,1300,0,1,0,0,226,22971
2007-01-01,1993,23801,1411,1,3,0,0,247,25463
2007-01-01,1992,28146,1857,0,1,0,0,207,30211
2007-01-01,1991,28962,2700,0,3,0,0,226,31891
2007-01-01,1990,30693,3351,0,8,0,0,242,34294
2007-01-01,1989,31318,3530,0,4,0,0,242,35094
2007-01-01,1988,32986,3532,0,2,0,0,254,36774
2007-01-01,1987,33864,3623,0,3,0,0,277,37767
2007-01-01,1986,33980,3608,0,3,0,0,314,37905
2007-01-01,1985,32743,3621,0,3,0,0,324,36691
2007-01-01,1984,32803,3714,0,1,0,0,357,36875
2007-01-01,1983,32816,4004,0,1,0,0,392,37213
2007-01-01,1982,30597,3678,0,0,0,0,367,34642
2007-01-01,1981,29136,3782,0,3,0,0,394,33315
2007-01-01,1980,28218,4019,0,0,0,0,394,32631
2007-01-01,1979,27301,4101,0,1,0,0,398,31801
2007-01-01,1978,26670,4205,0,1,0,0,436,31312
2007-01-01,1977,26717,4125,0,1,0,0,439,31282
2007-01-01,1976,27222,4026,0,4,0,0,487,31739
2007-01-01,1975,27139,4358,0,5,0,0,539,32041
2007-01-01,1974,27019,4528,0,4,0,0,544,32095
2007-01-01,1973,26784,4265,0,3,0,0,552,31604
2007-01-01,1972,27245,4575,0,5,0,0,620,32445
2007-01-01,1971,27634,4587,0,8,0,0,702,32931
2007-01-01,1970,27032,4524,0,8,0,0,689,32253
2007-01-01,1969,25995,4564,0,9,0,0,620,31188
2007-01-01,1968,25802,4765,1,6,0,0,665,31239
2007-01-01,1967,25251,5117,0,5,0,0,682,31055
2007-01-01,1966,24986,5536,0,4,0,0,646,31172
2007-01-01,1965,24153,5760,0,6,0,0,605,30524
2007-01-01,1964,25179,6373,0,6,0,0,599,32157
2007-01-01,1963,25829,6818,0,4,0,0,581,33232
2007-01-01,1962,26469,7430,0,4,0,0,566,34469
2007-01-01,1961,27005,7683,0,7,0,0,629,35324
2007-01-01,1960,26641,8064,0,4,0,0,566,35275
2007-01-01,1959,26000,8176,0,6,0,0,532,34714
2007-01-01,1958,25697,8360,0,4,0,0,511,34572
2007-01-01,1957,24590,8263,1,5,0,0,546,33405
2007-01-01,1956,23037,8071,0,2,0,0,536,31646
2007-01-01,1955,22682,8233,0,9,0,0,506,31430
2007-01-01,1954,21592,8389,0,1,0,0,527,30509
2007-01-01,1953,19885,7745,0,4,0,0,490,28124
2007-01-01,1952,20039,8148,0,2,0,0,536,28725
2007-01-01,1951,20091,8069,0,3,0,0,525,28688
2007-01-01,1950,19359,7788,0,3,0,0,637,27787
2007-01-01,1949,20137,8524,0,4,0,0,673,29338
2007-01-01,1948,18815,7755,0,2,0,0,610,27182
2007-01-01,1947,17297,7409,0,1,0,0,609,25316
2007-01-01,1946,15376,6303,0,3,0,0,634,22316
2007-01-01,1945,16248,4294,0,1,0,0,416,20959
2007-01-01,1944,17867,3958,0,2,0,0,396,22223
2007-01-01,1943,19581,3520,0,0,0,0,354,23455
2007-01-01,1942,20264,4545,0,0,0,0,510,25319
2007-01-01,1941,20156,6302,0,1,0,0,767,27226
2007-01-01,1940,18974,6437,0,1,0,0,895,26307
2007-01-01,1939,18551,7061,0,0,0,0,974,26586
2007-01-01,1938,18033,7058,0,1,0,0,977,26069
2007-01-01,1937,16664,7234,0,1,0,0,1111,25010
2007-01-01,1936,16026,5797,0,0,0,0,805,22628
2007-01-01,1935,14870,4991,0,0,0,0,729,20590
2007-01-01,1934,13599,4065,0,0,0,0,586,18250
2007-01-01,1933,13765,4352,0,0,0,0,512,18629
2007-01-01,1932,13915,4809,0,0,0,0,550,19274
2007-01-01,1931,13267,4353,0,0,0,0,575,18195
2007-01-01,1930,12517,4766,0,1,0,0,549,17833
2007-01-01,1929,11415,4292,0,1,0,0,539,16247
2007-01-01,1928,11210,4356,0,0,0,0,553,16119
2007-01-01,1927,10007,4113,0,0,0,0,604,14724
2007-01-01,1926,8638,3656,0,1,0,0,490,12785
2007-01-01,1925,7855,3189,0,0,0,0,438,11482
2007-01-01,1924,6703,2750,0,1,0,0,378,9832
2007-01-01,1923,6145,2426,0,0,0,0,342,8913
2007-01-01,1922,5101,1943,0,0,0,0,274,7318
2007-01-01,1921,4149,1452,0,0,0,0,240,5841
2007-01-01,1920,2972,1104,0,0,0,0,142,4218
2007-01-01,1919,2374,841,0,0,0,0,115,3330
2007-01-01,1918,1995,833,0,0,0,0,104,2932
2007-01-01,1917,1295,468,0,0,0,0,50,1813
2007-01-01,1916,1188,382,0,0,0,0,39,1609
2007-01-01,1915,1136,336,0,0,0,0,35,1507
2007-01-01,1914,1131,329,0,0,0,0,33,1493
2007-01-01,1913,860,242,0,0,0,0,21,1123
2007-01-01,1912,743,183,0,0,0,0,11,937
2007-01-01,1911,472,108,0,0,0,0,11,591
2007-01-01,1910,343,79,0,0,0,0,7,429
2007-01-01,1909,215,53,0,0,0,0,7,275
2007-01-01,1908,156,35,0,0,0,0,4,195
2007-01-01,1907,95,15,0,0,0,0,2,112
2007-01-01,1906,63,26,0,0,0,0,2,91
2007-01-01,1905,36,7,0,0,0,0,0,43
2007-01-01,1904,12,10,0,0,0,0,0,22
2007-01-01,1903,9,5,0,0,0,0,1,15
2007-01-01,1902,6,3,0,0,0,0,0,9
2007-01-01,1901,2,0,0,0,0,0,0,2
2007-01-01,1900,1,2,0,0,0,0,0,3
2007-01-01,1899,1,1,0,0,0,0,0,2
2007-01-01,1898,0,1,0,0,0,0,0,1
2007-01-01,1893,0,1,0,0,0,0,0,1
2007-07-01,2007,10244,369,0,0,0,0,19,10632
2007-07-01,2006,21598,893,0,0,0,0,120,22611
2007-07-01,2005,20818,807,0,1,0,0,175,21801
2007-07-01,2004,19431,818,0,0,0,0,195,20444
2007-07-01,2003,19934,835,0,0,0,0,138,20907
2007-07-01,2002,18895,861,0,1,0,0,163,19920
2007-07-01,2001,18339,890,0,1,0,0,185,19415
2007-07-01,2000,18769,1020,0,1,0,0,176,19966
2007-07-01,1999,17886,950,0,0,0,0,228,19064
2007-07-01,1998,16853,920,0,0,0,0,220,17993
2007-07-01,1997,17186,951,0,1,0,0,236,18374
2007-07-01,1996,17928,1060,0,0,0,0,219,19207
2007-07-01,1995,19546,1159,0,0,0,0,245,20950
2007-07-01,1994,21479,1250,0,1,0,0,231,22961
2007-07-01,1993,23876,1319,1,3,0,0,244,25443
2007-07-01,1992,28261,1713,0,1,0,0,209,30184
2007-07-01,1991,29031,2607,0,2,0,0,234,31874
2007-07-01,1990,30886,3122,0,7,0,0,239,34254
2007-07-01,1989,31560,3252,0,4,0,0,236,35052
2007-07-01,1988,33207,3283,0,2,0,0,271,36763
2007-07-01,1987,34049,3389,0,3,0,0,305,37746
2007-07-01,1986,34170,3380,0,3,0,0,355,37908
2007-07-01,1985,32906,3423,0,3,0,0,358,36690
2007-07-01,1984,32958,3506,0,1,0,0,411,36876
2007-07-01,1983,32963,3806,0,1,0,0,446,37216
2007-07-01,1982,30715,3504,0,0,0,0,443,34662
2007-07-01,1981,29247,3618,0,3,0,0,446,33314
2007-07-01,1980,28331,3857,0,0,0,0,435,32623
2007-07-01,1979,27391,3958,0,1,0,0,453,31803
2007-07-01,1978,26711,4092,0,1,0,0,470,31274
2007-07-01,1977,26765,4026,0,2,0,0,487,31280
2007-07-01,1976,27260,3926,0,4,0,0,526,31716
2007-07-01,1975,27194,4258,0,5,0,0,569,32026
2007-07-01,1974,27032,4438,0,4,0,0,595,32069
2007-07-01,1973,26807,4195,0,3,0,0,592,31597
2007-07-01,1972,27260,4493,0,5,0,0,646,32404
2007-07-01,1971,27652,4494,0,8,0,0,720,32874
2007-07-01,1970,27022,4434,0,8,0,0,742,32206
2007-07-01,1969,26007,4482,0,10,0,0,655,31154
2007-07-01,1968,25805,4675,1,6,0,0,695,31182
2007-07-01,1967,25279,5008,0,5,0,0,711,31003
2007-07-01,1966,24990,5429,0,4,0,0,678,31101
2007-07-01,1965,24150,5656,0,6,0,0,639,30451
2007-07-01,1964,25175,6287,0,6,0,0,634,32102
2007-07-01,1963,25826,6693,0,4,0,0,605,33128
2007-07-01,1962,26472,7299,0,3,0,0,587,34361
2007-07-01,1961,26989,7560,0,6,0,0,649,35204
2007-07-01,1960,26629,7913,0,4,0,0,595,35141
2007-07-01,1959,25977,8030,0,6,0,0,575,34588
2007-07-01,1958,25674,8215,0,4,0,0,538,34431
2007-07-01,1957,24535,8140,1,5,0,0,563,33244
2007-07-01,1956,23004,7933,0,2,0,0,558,31497
2007-07-01,1955,22624,8103,0,9,0,0,525,31261
2007-07-01,1954,21533,8253,0,1,0,0,560,30347
2007-07-01,1953,19808,7608,0,4,0,0,512,27932
2007-07-01,1952,19977,7972,0,2,0,0,572,28523
2007-07-01,1951,19984,7910,0,3,0,0,572,28469
2007-07-01,1950,19249,7622,0,3,0,0,687,27561
2007-07-01,1949,20019,8360,0,4,0,0,716,29099
2007-07-01,1948,18672,7592,0,2,0,0,650,26916
2007-07-01,1947,17165,7238,0,1,0,0,657,25061
2007-07-01,1946,15248,6177,0,3,0,0,655,22083
2007-07-01,1945,16109,4202,0,1,0,0,435,20747
2007-07-01,1944,17660,3848,0,2,0,0,411,21921
2007-07-01,1943,19354,3439,0,0,0,0,367,23160
2007-07-01,1942,20027,4443,0,0,0,0,531,25001
2007-07-01,1941,19942,6113,0,0,0,0,798,26853
2007-07-01,1940,18708,6260,0,1,0,0,936,25905
2007-07-01,1939,18307,6872,0,0,0,0,1010,26189
2007-07-01,1938,17762,6864,0,1,0,0,1022,25649
2007-07-01,1937,16405,7055,0,1,0,0,1136,24597
2007-07-01,1936,15744,5611,0,0,0,0,828,22183
2007-07-01,1935,14585,4833,0,0,0,0,735,20153
2007-07-01,1934,13323,3933,0,0,0,0,593,17849
2007-07-01,1933,13443,4211,0,0,0,0,518,18172
2007-07-01,1932,13559,4647,0,0,0,0,562,18768
2007-07-01,1931,12906,4171,0,0,0,0,591,17668
2007-07-01,1930,12135,4582,0,1,0,0,553,17271
2007-07-01,1929,11015,4097,0,1,0,0,555,15668
2007-07-01,1928,10811,4176,0,0,0,0,553,15540
2007-07-01,1927,9594,3903,0,0,0,0,610,14107
2007-07-01,1926,8284,3437,0,1,0,0,486,12208
2007-07-01,1925,7480,3019,0,0,0,0,445,10944
2007-07-01,1924,6350,2594,0,1,0,0,373,9318
2007-07-01,1923,5740,2276,0,0,0,0,334,8350
2007-07-01,1922,4773,1822,0,0,0,0,267,6862
2007-07-01,1921,3826,1314,0,0,0,0,232,5372
2007-07-01,1920,2743,1007,0,0,0,0,135,3885
2007-07-01,1919,2144,766,0,0,0,0,106,3016
2007-07-01,1918,1803,752,0,0,0,0,102,2657
2007-07-01,1917,1151,417,0,0,0,0,45,1613
2007-07-01,1916,1031,339,0,0,0,0,32,1402
2007-07-01,1915,996,292,0,0,0,0,31,1319
2007-07-01,1914,987,279,0,0,0,0,29,1295
2007-07-01,1913,731,214,0,0,0,0,20,965
2007-07-01,1912,629,159,0,0,0,0,7,795
2007-07-01,1911,382,100,0,0,0,0,8,490
2007-07-01,1910,274,74,0,0,0,0,6,354
2007-07-01,1909,182,42,0,0,0,0,7,231
2007-07-01,1908,127,28,0,0,0,0,4,159
2007-07-01,1907,74,14,0,0,0,0,2,90
2007-07-01,1906,49,25,0,0,0,0,1,75
2007-07-01,1905,24,7,0,0,0,0,0,31
2007-07-01,1904,8,10,0,0,0,0,0,18
2007-07-01,1903,8,5,0,0,0,0,1,14
2007-07-01,1902,6,3,0,0,0,0,0,9
2007-07-01,1901,2,0,0,0,0,0,0,2
2007-07-01,1900,1,2,0,0,0,0,0,3
2007-07-01,1899,1,1,0,0,0,0,0,2
2007-07-01,1898,0,1,0,0,0,0,0,1
2008-01-01,2007,21760,765,0,0,0,0,66,22591
2008-01-01,2006,21774,849,0,0,0,0,144,22767
2008-01-01,2005,20878,775,0,1,0,0,184,21838
2008-01-01,2004,19467,792,0,0,0,0,208,20467
2008-01-01,2003,19960,807,0,0,0,0,152,20919
2008-01-01,2002,18922,820,0,1,0,0,175,19918
2008-01-01,2001,18359,862,0,1,0,0,192,19414
2008-01-01,2000,18797,984,0,1,0,0,184,19966
2008-01-01,1999,17908,915,0,0,0,0,226,19049
2008-01-01,1998,16868,893,0,0,0,0,222,17983
2008-01-01,1997,17213,910,0,1,0,0,247,18371
2008-01-01,1996,17955,1021,0,0,0,0,222,19198
2008-01-01,1995,19575,1115,0,0,0,0,253,20943
2008-01-01,1994,21513,1208,0,2,0,0,239,22962
2008-01-01,1993,23922,1254,0,3,0,0,253,25432
2008-01-01,1992,28313,1630,0,1,0,0,218,30162
2008-01-01,1991,29123,2486,0,2,0,0,250,31861
2008-01-01,1990,31026,2954,0,7,0,0,275,34262
2008-01-01,1989,31757,3031,0,5,0,0,268,35061
2008-01-01,1988,33325,3128,0,2,0,0,313,36768
2008-01-01,1987,34156,3256,0,2,0,0,374,37788
2008-01-01,1986,34268,3238,0,3,0,0,408,37917
2008-01-01,1985,32981,3316,0,3,0,0,440,36740
2008-01-01,1984,33023,3400,0,1,0,0,495,36919
2008-01-01,1983,33014,3694,0,1,0,0,509,37218
2008-01-01,1982,30761,3403,0,0,0,0,526,34690
2008-01-01,1981,29265,3532,0,3,0,0,521,33321
2008-01-01,1980,28347,3777,0,0,0,0,506,32630
2008-01-01,1979,27421,3870,0,1,0,0,516,31808
2008-01-01,1978,26711,4010,0,1,0,0,533,31255
2008-01-01,1977,26767,3957,0,2,0,0,542,31268
2008-01-01,1976,27249,3873,0,3,0,0,569,31694
2008-01-01,1975,27188,4198,0,5,0,0,617,32008
2008-01-01,1974,27031,4374,0,5,0,0,648,32058
2008-01-01,1973,26796,4129,0,3,0,0,629,31557
2008-01-01,1972,27271,4437,0,6,0,0,691,32405
2008-01-01,1971,27652,4423,0,8,0,0,773,32856
2008-01-01,1970,27009,4381,0,8,0,0,770,32168
2008-01-01,1969,25993,4416,0,10,0,0,714,31133
2008-01-01,1968,25798,4600,0,6,0,0,741,31145
2008-01-01,1967,25283,4940,0,5,0,0,743,30971
2008-01-01,1966,24975,5361,0,5,0,0,726,31067
2008-01-01,1965,24119,5597,0,7,0,0,680,30403
2008-01-01,1964,25154,6202,0,5,0,0,688,32049
2008-01-01,1963,25796,6598,0,5,0,0,636,33035
2008-01-01,1962,26420,7214,0,4,0,0,630,34268
2008-01-01,1961,26941,7466,0,6,0,0,695,35108
2008-01-01,1960,26583,7806,0,4,0,0,634,35027
2008-01-01,1959,25911,7949,0,7,0,0,615,34482
2008-01-01,1958,25598,8126,0,4,0,0,578,34306
2008-01-01,1957,24460,8038,0,5,0,0,605,33108
2008-01-01,1956,22939,7819,0,3,0,0,590,31351
2008-01-01,1955,22566,7978,0,9,0,0,564,31117
2008-01-01,1954,21437,8132,0,1,0,0,600,30170
2008-01-01,1953,19720,7470,0,4,0,0,548,27742
2008-01-01,1952,19900,7852,0,2,0,0,621,28375
2008-01-01,1951,19887,7776,0,3,0,0,632,28298
2008-01-01,1950,19157,7497,0,3,0,0,746,27403
2008-01-01,1949,19906,8216,0,4,0,0,772,28898
2008-01-01,1948,18528,7475,0,2,0,0,690,26695
2008-01-01,1947,17048,7109,0,1,0,0,704,24862
2008-01-01,1946,15141,6060,0,3,0,0,693,21897
2008-01-01,1945,15970,4095,0,2,0,0,476,20543
2008-01-01,1944,17479,3752,0,1,0,0,457,21689
2008-01-01,1943,19128,3372,0,0,0,0,391,22891
2008-01-01,1942,19814,4321,0,0,0,0,571,24706
2008-01-01,1941,19706,5978,0,0,0,0,839,26523
2008-01-01,1940,18482,6107,0,1,0,0,985,25575
2008-01-01,1939,18083,6683,0,0,0,0,1059,25825
2008-01-01,1938,17512,6679,0,2,0,0,1078,25271
2008-01-01,1937,16149,6878,0,1,0,0,1186,24214
2008-01-01,1936,15489,5452,0,0,0,0,877,21818
2008-01-01,1935,14335,4711,0,0,0,0,770,19816
2008-01-01,1934,13061,3829,0,0,0,0,609,17499
2008-01-01,1933,13143,4080,0,0,0,0,539,17762
2008-01-01,1932,13253,4498,0,0,0,0,576,18327
2008-01-01,1931,12574,4007,0,0,0,0,614,17195
2008-01-01,1930,11768,4431,0,1,0,0,566,16766
2008-01-01,1929,10698,3934,0,1,0,0,561,15194
2008-01-01,1928,10440,3992,0,0,0,0,556,14988
2008-01-01,1927,9226,3721,0,0,0,0,616,13563
2008-01-01,1926,7974,3282,0,1,0,0,487,11744
2008-01-01,1925,7150,2858,0,0,0,0,432,10440
2008-01-01,1924,6076,2444,0,1,0,0,374,8895
2008-01-01,1923,5436,2127,0,0,0,0,334,7897
2008-01-01,1922,4489,1680,0,0,0,0,271,6440
2008-01-01,1921,3552,1214,0,0,0,0,225,4991
2008-01-01,1920,2515,937,0,0,0,0,123,3575
2008-01-01,1919,1974,707,0,0,0,0,102,2783
2008-01-01,1918,1651,691,0,0,0,0,100,2442
2008-01-01,1917,1043,367,0,0,0,0,42,1452
2008-01-01,1916,923,294,0,0,0,0,28,1245
2008-01-01,1915,879,271,0,0,0,0,30,1180
2008-01-01,1914,858,259,0,0,0,0,27,1144
2008-01-01,1913,632,192,0,0,0,0,19,843
2008-01-01,1912,539,144,0,0,0,0,6,689
2008-01-01,1911,320,92,0,0,0,0,7,419
2008-01-01,1910,213,62,0,0,0,0,3,278
2008-01-01,1909,155,34,0,0,0,0,5,194
2008-01-01,1908,104,24,0,0,0,0,4,132
2008-01-01,1907,54,13,0,0,0,0,2,69
2008-01-01,1906,35,20,0,0,0,0,1,56
2008-01-01,1905,21,6,0,0,0,0,0,27
2008-01-01,1904,4,8,0,0,0,0,0,12
2008-01-01,1903,7,5,0,0,0,0,1,13
2008-01-01,1902,6,3,0,0,0,0,0,9
2008-01-01,1901,1,0,0,0,0,0,0,1
2008-01-01,1900,1,1,0,0,0,0,0,2
2008-01-01,1899,1,1,0,0,0,0,0,2
2008-01-01,1898,0,1,0,0,0,0,0,1
2008-07-01,2008,10918,353,0,0,1,0,19,11291
2008-07-01,2007,22827,751,0,0,0,0,87,23665
2008-07-01,2006,21826,814,0,0,0,0,159,22799
2008-07-01,2005,20895,751,0,1,0,0,194,21841
2008-07-01,2004,19492,764,0,0,0,0,214,20470
2008-07-01,2003,19967,793,0,0,0,0,162,20922
2008-07-01,2002,18937,793,0,1,0,0,179,19910
2008-07-01,2001,18373,839,0,1,0,0,194,19407
2008-07-01,2000,18807,958,0,1,0,0,188,19954
2008-07-01,1999,17919,893,0,0,0,0,228,19040
2008-07-01,1998,16889,863,0,0,0,0,228,17980
2008-07-01,1997,17232,882,0,1,0,0,248,18363
2008-07-01,1996,17966,994,0,0,0,0,221,19181
2008-07-01,1995,19591,1081,0,0,0,0,253,20925
2008-07-01,1994,21543,1157,0,2,0,0,243,22945
2008-07-01,1993,23982,1167,0,3,0,0,255,25407
2008-07-01,1992,28326,1593,0,1,0,0,213,30133
2008-07-01,1991,29175,2400,0,1,0,0,255,31831
2008-07-01,1990,31121,2835,0,6,0,0,280,34242
2008-07-01,1989,31849,2910,0,5,0,0,278,35042
2008-07-01,1988,33374,3035,0,2,0,0,332,36743
2008-07-01,1987,34180,3168,0,2,0,0,387,37737
2008-07-01,1986,34270,3175,0,2,0,0,443,37890
2008-07-01,1985,32983,3238,0,3,0,0,481,36705
2008-07-01,1984,32991,3329,0,1,0,0,525,36846
2008-07-01,1983,32956,3634,0,1,0,0,553,37144
2008-07-01,1982,30700,3347,0,0,0,0,576,34623
2008-07-01,1981,29219,3479,0,3,0,0,551,33252
2008-07-01,1980,28302,3720,0,0,0,0,567,32589
2008-07-01,1979,27389,3819,0,1,0,0,544,31753
2008-07-01,1978,26672,3960,0,1,0,0,560,31193
2008-07-01,1977,26715,3926,0,2,0,0,568,31211
2008-07-01,1976,27213,3823,0,3,0,0,603,31642
2008-07-01,1975,27132,4159,0,5,0,0,643,31939
2008-07-01,1974,26987,4323,0,5,0,0,684,31999
2008-07-01,1973,26736,4096,0,3,0,0,653,31488
2008-07-01,1972,27218,4404,0,5,0,0,710,32337
2008-07-01,1971,27604,4382,0,8,0,0,795,32789
2008-07-01,1970,26961,4347,0,9,0,0,791,32108
2008-07-01,1969,25946,4393,0,8,0,0,736,31083
2008-07-01,1968,25731,4569,0,6,0,0,762,31068
2008-07-01,1967,25230,4895,0,5,0,0,776,30906
2008-07-01,1966,24942,5310,0,4,0,0,747,31003
2008-07-01,1965,24077,5548,0,7,0,0,695,30327
2008-07-01,1964,25098,6156,0,5,0,0,708,31967
2008-07-01,1963,25733,6542,0,6,0,0,659,32940
2008-07-01,1962,26331,7158,0,4,0,0,655,34148
2008-07-01,1961,26853,7393,0,6,0,0,713,34965
2008-07-01,1960,26515,7750,0,5,0,0,646,34916
2008-07-01,1959,25836,7864,0,6,0,0,626,34332
2008-07-01,1958,25487,8048,0,5,0,0,596,34136
2008-07-01,1957,24370,7953,0,5,0,0,610,32938
2008-07-01,1956,22856,7732,0,3,0,0,609,31200
2008-07-01,1955,22467,7883,0,9,0,0,594,30953
2008-07-01,1954,21339,8037,0,1,0,0,626,30003
2008-07-01,1953,19612,7344,0,4,0,0,595,27555
2008-07-01,1952,19787,7721,0,2,0,0,657,28167
2008-07-01,1951,19791,7639,0,3,0,0,664,28097
2008-07-01,1950,19036,7381,0,3,0,0,770,27190
2008-07-01,1949,19756,8089,0,4,0,0,798,28647
2008-07-01,1948,18396,7346,0,3,0,0,734,26479
2008-07-01,1947,16939,6969,0,1,0,0,738,24647
2008-07-01,1946,15007,5935,0,4,0,0,719,21665
2008-07-01,1945,15810,4010,0,2,0,0,490,20312
2008-07-01,1944,17277,3687,0,1,0,0,466,21431
2008-07-01,1943,18909,3296,0,0,0,0,405,22610
2008-07-01,1942,19569,4251,0,0,0,0,584,24404
2008-07-01,1941,19453,5841,0,0,0,0,856,26150
2008-07-01,1940,18253,5955,0,1,0,0,1005,25214
2008-07-01,1939,17850,6503,0,0,0,0,1086,25439
2008-07-01,1938,17226,6511,0,2,0,0,1098,24837
2008-07-01,1937,15888,6696,0,1,0,0,1208,23793
2008-07-01,1936,15201,5313,0,0,0,0,893,21407
2008-07-01,1935,14048,4601,0,0,0,0,774,19423
2008-07-01,1934,12750,3713,0,0,0,0,622,17085
2008-07-01,1933,12832,3947,0,0,0,0,550,17329
2008-07-01,1932,12906,4342,0,0,0,0,579,17827
2008-07-01,1931,12223,3867,0,0,0,0,617,16707
2008-07-01,1930,11398,4267,0,1,0,0,572,16238
2008-07-01,1929,10354,3781,0,1,0,0,567,14703
2008-07-01,1928,10080,3837,0,0,0,0,546,14463
2008-07-01,1927,8869,3565,0,0,0,0,596,13030
2008-07-01,1926,7639,3122,0,1,0,0,473,11235
2008-07-01,1925,6812,2725,0,0,0,0,421,9958
2008-07-01,1924,5739,2299,0,0,0,0,356,8394
2008-07-01,1923,5134,2001,0,0,0,0,318,7453
2008-07-01,1922,4153,1578,0,0,0,0,263,5994
2008-07-01,1921,3271,1119,0,0,0,0,217,4607
2008-07-01,1920,2295,849,0,0,0,0,122,3266
2008-07-01,1919,1805,634,0,0,0,0,101,2540
2008-07-01,1918,1490,614,0,0,0,0,91,2195
2008-07-01,1917,927,331,0,0,0,0,40,1298
2008-07-01,1916,836,266,0,0,0,0,27,1129
2008-07-01,1915,771,244,0,0,0,0,27,1042
2008-07-01,1914,741,237,0,0,0,0,25,1003
2008-07-01,1913,537,167,0,0,0,0,18,722
2008-07-01,1912,453,126,0,0,0,0,6,585
2008-07-01,1911,265,81,0,0,0,0,7,353
2008-07-01,1910,172,58,0,0,0,0,3,233
2008-07-01,1909,129,31,0,0,0,0,4,164
2008-07-01,1908,87,22,0,0,0,0,4,113
2008-07-01,1907,46,12,0,0,0,0,1,59
2008-07-01,1906,25,19,0,0,0,0,1,45
2008-07-01,1905,16,5,0,0,0,0,0,21
2008-07-01,1904,3,7,0,0,0,0,0,10
2008-07-01,1903,2,5,0,0,0,0,1,8
2008-07-01,1902,4,3,0,0,0,0,0,7
2008-07-01,1901,1,0,0,0,0,0,0,1
2008-07-01,1900,1,1,0,0,0,0,0,2
2008-07-01,1899,1,1,0,0,0,0,0,2
2008-07-01,1898,0,1,0,0,0,0,0,1
2009-01-01,2008,22675,688,0,0,0,0,79,23442
2009-01-01,2007,22978,727,0,0,0,0,101,23806
2009-01-01,2006,21852,786,0,0,0,0,165,22803
2009-01-01,2005,20907,734,0,1,0,0,204,21846
2009-01-01,2004,19492,752,0,0,0,0,222,20466
2009-01-01,2003,19962,779,0,0,0,0,174,20915
2009-01-01,2002,18946,774,0,1,0,0,187,19908
2009-01-01,2001,18371,823,0,1,0,0,201,19396
2009-01-01,2000,18811,941,0,1,0,0,188,19941
2009-01-01,1999,17930,873,0,0,0,0,233,19036
2009-01-01,1998,16891,848,0,0,0,0,231,17970
2009-01-01,1997,17233,863,0,1,0,0,246,18343
2009-01-01,1996,17968,978,0,0,0,0,227,19173
2009-01-01,1995,19604,1053,0,0,0,0,250,20907
2009-01-01,1994,21553,1124,0,2,0,0,248,22927
2009-01-01,1993,24008,1121,0,3,0,0,270,25402
2009-01-01,1992,28345,1538,0,1,0,0,233,30117
2009-01-01,1991,29219,2315,0,1,0,0,290,31825
2009-01-01,1990,31200,2723,0,6,0,0,302,34231
2009-01-01,1989,31917,2792,0,5,0,0,298,35012
2009-01-01,1988,33431,2933,0,2,0,0,355,36721
2009-01-01,1987,34222,3055,0,2,0,0,433,37712
2009-01-01,1986,34275,3098,0,2,0,0,504,37879
2009-01-01,1985,32978,3153,0,3,0,0,543,36677
2009-01-01,1984,32947,3263,0,1,0,0,589,36800
2009-01-01,1983,32907,3559,0,1,0,0,585,37052
2009-01-01,1982,30684,3278,0,0,0,0,601,34563
2009-01-01,1981,29179,3407,0,3,0,0,586,33175
2009-01-01,1980,28287,3664,0,0,0,0,595,32546
2009-01-01,1979,27361,3759,0,1,0,0,580,31701
2009-01-01,1978,26635,3892,0,1,0,0,607,31135
2009-01-01,1977,26697,3871,0,2,0,0,628,31198
2009-01-01,1976,27164,3778,0,3,0,0,622,31567
2009-01-01,1975,27109,4111,0,5,0,0,677,31902
2009-01-01,1974,26948,4261,0,5,0,0,704,31918
2009-01-01,1973,26676,4052,0,3,0,0,675,31406
2009-01-01,1972,27191,4353,0,6,0,0,741,32291
2009-01-01,1971,27571,4324,0,8,0,0,810,32713
2009-01-01,1970,26909,4299,0,9,0,0,817,32034
2009-01-01,1969,25907,4337,0,9,0,0,751,31004
2009-01-01,1968,25681,4513,0,5,0,0,770,30969
2009-01-01,1967,25201,4841,0,4,0,0,809,30855
2009-01-01,1966,24898,5246,0,4,0,0,771,30919
2009-01-01,1965,24039,5493,0,7,0,0,708,30247
2009-01-01,1964,25047,6092,0,6,0,0,720,31865
2009-01-01,1963,25662,6478,0,6,0,0,672,32818
2009-01-01,1962,26255,7072,0,4,0,0,675,34006
2009-01-01,1961,26780,7316,0,6,0,0,715,34817
2009-01-01,1960,26445,7671,0,5,0,0,658,34779
2009-01-01,1959,25765,7761,0,6,0,0,642,34174
2009-01-01,1958,25413,7933,0,6,0,0,611,33963
2009-01-01,1957,24270,7865,0,5,0,0,616,32756
2009-01-01,1956,22761,7631,0,3,0,0,636,31031
2009-01-01,1955,22389,7780,0,9,0,0,613,30791
2009-01-01,1954,21250,7922,0,1,0,0,658,29831
2009-01-01,1953,19524,7230,0,4,0,0,645,27403
2009-01-01,1952,19686,7581,0,2,0,0,709,27978
2009-01-01,1951,19682,7490,0,3,0,0,713,27888
2009-01-01,1950,18934,7273,0,3,0,0,810,27020
2009-01-01,1949,19642,7956,0,4,0,0,840,28442
2009-01-01,1948,18279,7238,0,3,0,0,779,26299
2009-01-01,1947,16793,6846,0,1,0,0,761,24401
2009-01-01,1946,14902,5832,0,4,0,0,751,21489
2009-01-01,1945,15674,3932,0,2,0,0,508,20116
2009-01-01,1944,17093,3620,0,1,0,0,484,21198
2009-01-01,1943,18697,3222,0,0,0,0,414,22333
2009-01-01,1942,19349,4156,0,0,0,0,611,24116
2009-01-01,1941,19236,5716,0,0,0,0,889,25841
2009-01-01,1940,18041,5838,0,1,0,0,1029,24909
2009-01-01,1939,17602,6360,0,0,0,0,1110,25072
2009-01-01,1938,16958,6358,0,2,0,0,1127,24445
2009-01-01,1937,15641,6529,0,1,0,0,1236,23407
2009-01-01,1936,14951,5178,0,0,0,0,918,21047
2009-01-01,1935,13787,4468,0,0,0,0,773,19028
2009-01-01,1934,12468,3620,0,0,0,0,628,16716
2009-01-01,1933,12538,3841,0,0,0,0,555,16934
2009-01-01,1932,12576,4199,0,0,0,0,588,17363
2009-01-01,1931,11903,3736,0,0,0,0,630,16269
2009-01-01,1930,11073,4136,0,1,0,0,571,15781
2009-01-01,1929,9996,3639,0,1,0,0,567,14203
2009-01-01,1928,9732,3656,0,0,0,0,545,13933
2009-01-01,1927,8514,3389,0,0,0,0,596,12499
2009-01-01,1926,7334,2959,0,0,0,0,468,10761
2009-01-01,1925,6471,2568,0,0,0,0,408,9447
2009-01-01,1924,5413,2172,0,0,0,0,347,7932
2009-01-01,1923,4855,1885,0,0,0,0,312,7052
2009-01-01,1922,3910,1458,0,0,0,0,253,5621
2009-01-01,1921,3041,1054,0,0,0,0,205,4300
2009-01-01,1920,2120,783,0,0,0,0,123,3026
2009-01-01,1919,1650,587,0,0,0,0,92,2329
2009-01-01,1918,1358,565,0,0,0,0,85,2008
2009-01-01,1917,842,296,0,0,0,0,38,1176
2009-01-01,1916,740,250,0,0,0,0,25,1015
2009-01-01,1915,682,216,0,0,0,0,27,925
2009-01-01,1914,652,211,0,0,0,0,24,887
2009-01-01,1913,468,146,0,0,0,0,15,629
2009-01-01,1912,381,110,0,0,0,0,5,496
2009-01-01,1911,223,72,0,0,0,0,5,300
2009-01-01,1910,156,50,0,0,0,0,3,209
2009-01-01,1909,108,28,0,0,0,0,4,140
2009-01-01,1908,71,19,0,0,0,0,4,94
2009-01-01,1907,31,12,0,0,0,0,1,44
2009-01-01,1906,22,15,0,0,0,0,0,37
2009-01-01,1905,13,5,0,0,0,0,0,18
2009-01-01,1904,2,7,0,0,0,0,0,9
2009-01-01,1903,1,5,0,0,0,0,1,7
2009-01-01,1902,4,3,0,0,0,0,0,7
2009-01-01,1901,1,0,0,0,0,0,0,1
2009-01-01,1900,1,1,0,0,0,0,0,2
2009-01-01,1899,1,1,0,0,0,0,0,2
2009-01-01,1898,0,1,0,0,0,0,0,1
2009-07-01,2009,10159,300,0,0,0,0,16,10475
2009-07-01,2008,23374,679,0,0,0,0,116,24169
2009-07-01,2007,22997,709,0,0,0,0,109,23815
2009-07-01,2006,21838,770,0,0,0,0,171,22779
2009-07-01,2005,20904,709,0,0,0,0,207,21820
2009-07-01,2004,19485,739,0,0,0,0,225,20449
2009-07-01,2003,19964,764,0,0,0,0,172,20900
2009-07-01,2002,18936,764,0,0,0,0,190,19890
2009-07-01,2001,18358,812,0,1,0,0,202,19373
2009-07-01,2000,18800,923,0,1,0,0,192,19916
2009-07-01,1999,17923,862,0,0,0,0,227,19012
2009-07-01,1998,16893,838,0,0,0,0,227,17958
2009-07-01,1997,17233,845,0,0,0,0,245,18323
2009-07-01,1996,17973,960,0,0,0,0,226,19159
2009-07-01,1995,19620,1021,0,1,0,0,256,20898
2009-07-01,1994,21595,1071,0,0,0,0,248,22914
2009-07-01,1993,24004,1099,0,3,0,0,264,25370
2009-07-01,1992,28342,1507,0,1,0,0,230,30080
2009-07-01,1991,29265,2242,0,1,0,0,288,31796
2009-07-01,1990,31254,2640,0,3,0,0,304,34201
2009-07-01,1989,31942,2713,0,2,0,0,320,34977
2009-07-01,1988,33430,2869,0,2,0,0,375,36676
2009-07-01,1987,34233,3001,0,2,0,0,457,37693
2009-07-01,1986,34278,3043,0,2,0,0,497,37820
2009-07-01,1985,32969,3084,0,3,0,0,554,36610
2009-07-01,1984,32929,3209,0,1,0,0,598,36737
2009-07-01,1983,32868,3512,0,1,0,0,590,36971
2009-07-01,1982,30640,3234,0,0,0,0,616,34490
2009-07-01,1981,29148,3375,0,1,0,0,596,33120
2009-07-01,1980,28247,3627,0,0,0,0,581,32455
2009-07-01,1979,27326,3714,0,1,0,0,576,31617
2009-07-01,1978,26582,3864,0,1,0,0,603,31050
2009-07-01,1977,26660,3840,0,2,0,0,624,31126
2009-07-01,1976,27109,3747,0,4,0,0,627,31487
2009-07-01,1975,27051,4073,0,4,0,0,674,31802
2009-07-01,1974,26917,4223,0,5,0,0,715,31860
2009-07-01,1973,26644,4013,0,3,0,0,678,31338
2009-07-01,1972,27139,4317,0,6,0,0,738,32200
2009-07-01,1971,27537,4288,0,7,0,0,795,32627
2009-07-01,1970,26868,4267,0,6,0,0,803,31944
2009-07-01,1969,25865,4297,0,8,0,0,749,30919
2009-07-01,1968,25638,4489,0,4,0,0,773,30904
2009-07-01,1967,25156,4809,0,2,0,0,797,30764
2009-07-01,1966,24832,5208,0,3,0,0,764,30807
2009-07-01,1965,23979,5453,0,5,0,0,697,30134
2009-07-01,1964,25012,6042,0,4,0,0,718,31776
2009-07-01,1963,25607,6422,0,6,0,0,690,32725
2009-07-01,1962,26179,7015,0,4,0,0,681,33879
2009-07-01,1961,26712,7254,0,6,0,0,717,34689
2009-07-01,1960,26371,7605,0,5,0,0,651,34632
2009-07-01,1959,25692,7689,0,6,0,0,650,34037
2009-07-01,1958,25325,7867,0,5,0,0,621,33818
2009-07-01,1957,24184,7788,0,5,0,0,628,32605
2009-07-01,1956,22667,7567,0,3,0,0,648,30885
2009-07-01,1955,22284,7691,0,8,0,0,637,30620
2009-07-01,1954,21147,7803,0,1,0,0,710,29661
2009-07-01,1953,19418,7129,0,3,0,0,687,27237
2009-07-01,1952,19583,7465,0,1,0,0,748,27797
2009-07-01,1951,19552,7367,0,3,0,0,742,27664
2009-07-01,1950,18791,7148,0,2,0,0,833,26774
2009-07-01,1949,19493,7860,0,4,0,0,861,28218
2009-07-01,1948,18133,7127,0,1,0,0,789,26050
2009-07-01,1947,16639,6728,0,1,0,0,785,24153
2009-07-01,1946,14747,5718,0,3,0,0,759,21227
2009-07-01,1945,15496,3860,0,1,0,0,528,19885
2009-07-01,1944,16913,3553,0,1,0,0,497,20964
2009-07-01,1943,18496,3162,0,0,0,0,422,22080
2009-07-01,1942,19104,4091,0,0,0,0,614,23809
2009-07-01,1941,18958,5585,0,0,0,0,924,25467
2009-07-01,1940,17779,5718,0,1,0,0,1046,24544
2009-07-01,1939,17342,6223,0,0,0,0,1131,24696
2009-07-01,1938,16677,6207,0,2,0,0,1133,24019
2009-07-01,1937,15384,6360,0,1,0,0,1254,22999
2009-07-01,1936,14668,5043,0,0,0,0,941,20652
2009-07-01,1935,13494,4340,0,0,0,0,778,18612
2009-07-01,1934,12214,3503,0,0,0,0,627,16344
2009-07-01,1933,12223,3719,0,0,0,0,549,16491
2009-07-01,1932,12243,4060,0,0,0,0,592,16895
2009-07-01,1931,11524,3601,0,0,0,0,641,15766
2009-07-01,1930,10690,3975,0,1,0,0,565,15231
2009-07-01,1929,9629,3468,0,1,0,0,557,13655
2009-07-01,1928,9357,3508,0,0,0,0,523,13388
2009-07-01,1927,8142,3221,0,0,0,0,590,11953
2009-07-01,1926,6963,2805,0,0,0,0,456,10224
2009-07-01,1925,6130,2422,0,0,0,0,403,8955
2009-07-01,1924,5103,2033,0,0,0,0,335,7471
2009-07-01,1923,4549,1782,0,0,0,0,297,6628
2009-07-01,1922,3622,1351,0,0,0,0,237,5210
2009-07-01,1921,2794,995,0,0,0,0,188,3977
2009-07-01,1920,1934,717,0,0,0,0,120,2771
2009-07-01,1919,1498,533,0,0,0,0,83,2114
2009-07-01,1918,1219,506,0,0,0,0,73,1798
2009-07-01,1917,715,269,0,0,0,0,37,1021
2009-07-01,1916,654,211,0,0,0,0,23,888
2009-07-01,1915,585,194,0,0,0,0,25,804
2009-07-01,1914,547,184,0,0,0,0,21,752
2009-07-01,1913,399,132,0,0,0,0,13,544
2009-07-01,1912,308,98,0,0,0,0,4,410
2009-07-01,1911,189,65,0,0,0,0,4,258
2009-07-01,1910,128,48,0,0,0,0,2,178
2009-07-01,1909,83,22,0,0,0,0,3,108
2009-07-01,1908,47,16,0,0,0,0,2,65
2009-07-01,1907,22,11,0,0,0,0,1,34
2009-07-01,1906,16,13,0,0,0,0,0,29
2009-07-01,1905,12,5,0,0,0,0,0,17
2009-07-01,1904,2,7,0,0,0,0,0,9
2009-07-01,1903,1,5,0,0,0,0,0,6
2009-07-01,1902,2,3,0,0,0,0,0,5
2009-07-01,1901,1,0,0,0,0,0,0,1
2009-07-01,1900,1,1,0,0,0,0,0,2
2009-07-01,1899,0,1,0,0,0,0,0,1
2009-07-01,1898,0,1,0,0,0,0,0,1
2010-01-01,2009,20562,588,0,0,0,0,82,21232
2010-01-01,2008,23463,650,0,0,0,0,119,24232
2010-01-01,2007,22993,680,0,0,0,0,118,23791
2010-01-01,2006,21812,755,0,0,0,0,177,22744
2010-01-01,2005,20859,698,0,0,0,0,206,21763
2010-01-01,2004,19448,724,0,0,0,0,221,20393
2010-01-01,2003,19938,747,0,0,0,0,178,20863
2010-01-01,2002,18924,751,0,0,0,0,191,19866
2010-01-01,2001,18334,799,0,1,0,0,192,19326
2010-01-01,2000,18783,903,0,1,0,0,190,19877
2010-01-01,1999,17910,847,0,0,0,0,222,18979
2010-01-01,1998,16887,817,0,0,0,0,227,17931
2010-01-01,1997,17225,825,0,0,0,0,244,18294
2010-01-01,1996,17956,943,0,0,0,0,222,19121
2010-01-01,1995,19612,992,0,1,0,0,256,20861
2010-01-01,1994,21599,1034,0,0,0,0,246,22879
2010-01-01,1993,24007,1062,0,3,0,0,277,25349
2010-01-01,1992,28353,1459,0,2,0,0,243,30057
2010-01-01,1991,29309,2163,0,1,0,0,278,31751
2010-01-01,1990,31308,2539,0,4,0,0,326,34177
2010-01-01,1989,31999,2601,0,2,0,0,329,34931
2010-01-01,1988,33468,2747,0,1,0,0,380,36596
2010-01-01,1987,34244,2903,0,2,0,0,501,37650
2010-01-01,1986,34288,2946,0,2,0,0,506,37742
2010-01-01,1985,32969,2990,0,2,0,0,561,36522
2010-01-01,1984,32916,3120,0,1,0,0,583,36620
2010-01-01,1983,32848,3400,0,1,0,0,599,36848
2010-01-01,1982,30579,3154,0,0,0,0,620,34353
2010-01-01,1981,29101,3310,0,3,0,0,565,32979
2010-01-01,1980,28179,3556,0,0,0,0,551,32286
2010-01-01,1979,27245,3653,0,1,0,0,573,31472
2010-01-01,1978,26540,3812,0,1,0,0,578,30931
2010-01-01,1977,26601,3795,0,2,0,0,604,31002
2010-01-01,1976,27052,3700,0,3,0,0,620,31375
2010-01-01,1975,26989,4023,0,4,0,0,646,31662
2010-01-01,1974,26859,4169,0,5,0,0,696,31729
2010-01-01,1973,26596,3958,0,3,0,0,659,31216
2010-01-01,1972,27096,4274,0,5,0,0,720,32095
2010-01-01,1971,27487,4247,0,7,0,0,778,32519
2010-01-01,1970,26813,4225,0,7,0,0,785,31830
2010-01-01,1969,25815,4261,0,8,0,0,737,30821
2010-01-01,1968,25592,4451,0,5,0,0,757,30805
2010-01-01,1967,25096,4759,0,3,0,0,791,30649
2010-01-01,1966,24784,5159,0,3,0,0,751,30697
2010-01-01,1965,23937,5421,0,5,0,0,694,30057
2010-01-01,1964,24953,5983,0,4,0,0,704,31644
2010-01-01,1963,25553,6358,0,6,0,0,679,32596
2010-01-01,1962,26109,6930,0,4,0,0,661,33704
2010-01-01,1961,26625,7185,0,6,0,0,693,34509
2010-01-01,1960,26305,7524,0,5,0,0,666,34500
2010-01-01,1959,25613,7602,0,6,0,0,640,33861
2010-01-01,1958,25229,7772,0,5,0,0,632,33638
2010-01-01,1957,24095,7702,0,5,0,0,634,32436
2010-01-01,1956,22589,7477,0,3,0,0,674,30743
2010-01-01,1955,22192,7552,0,8,0,0,674,30426
2010-01-01,1954,21061,7641,0,1,0,0,794,29497
2010-01-01,1953,19296,6996,0,3,0,0,748,27043
2010-01-01,1952,19455,7314,0,1,0,0,805,27575
2010-01-01,1951,19456,7224,0,3,0,0,799,27482
2010-01-01,1950,18650,7007,0,2,0,0,866,26525
2010-01-01,1949,19331,7705,0,4,0,0,914,27954
2010-01-01,1948,18010,7009,0,2,0,0,816,25837
2010-01-01,1947,16513,6612,0,1,0,0,818,23944
2010-01-01,1946,14619,5585,0,3,0,0,797,21004
2010-01-01,1945,15335,3782,0,1,0,0,538,19656
2010-01-01,1944,16737,3469,0,1,0,0,506,20713
2010-01-01,1943,18287,3084,0,0,0,0,445,21816
2010-01-01,1942,18895,3992,0,0,0,0,635,23522
2010-01-01,1941,18710,5470,0,0,0,0,949,25129
2010-01-01,1940,17537,5590,0,0,0,0,1072,24199
2010-01-01,1939,17098,6064,0,0,0,0,1151,24313
2010-01-01,1938,16441,6038,0,2,0,0,1150,23631
2010-01-01,1937,15110,6203,0,1,0,0,1273,22587
2010-01-01,1936,14401,4911,0,0,0,0,952,20264
2010-01-01,1935,13205,4202,0,0,0,0,805,18212
2010-01-01,1934,11944,3401,0,0,0,0,637,15982
2010-01-01,1933,11942,3593,0,0,0,0,566,16101
2010-01-01,1932,11924,3910,0,0,0,0,608,16442
2010-01-01,1931,11187,3486,0,0,0,0,637,15310
2010-01-01,1930,10372,3831,0,1,0,0,575,14779
2010-01-01,1929,9275,3339,0,1,0,0,545,13160
2010-01-01,1928,9012,3369,0,0,0,0,516,12897
2010-01-01,1927,7779,3064,0,0,0,0,576,11419
2010-01-01,1926,6644,2669,0,0,0,0,449,9762
2010-01-01,1925,5832,2307,0,0,0,0,390,8529
2010-01-01,1924,4841,1909,0,0,0,0,328,7078
2010-01-01,1923,4259,1659,0,0,0,0,284,6202
2010-01-01,1922,3365,1271,0,0,0,0,219,4855
2010-01-01,1921,2589,922,0,0,0,0,171,3682
2010-01-01,1920,1794,659,0,0,0,0,113,2566
2010-01-01,1919,1335,496,0,0,0,0,78,1909
2010-01-01,1918,1097,457,0,0,0,0,67,1621
2010-01-01,1917,636,244,0,0,0,0,35,915
2010-01-01,1916,588,188,0,0,0,0,22,798
2010-01-01,1915,504,178,0,0,0,0,23,705
2010-01-01,1914,483,160,0,0,0,0,21,664
2010-01-01,1913,338,117,0,0,0,0,12,467
2010-01-01,1912,257,89,0,0,0,0,2,348
2010-01-01,1911,162,61,0,0,0,0,3,226
2010-01-01,1910,107,44,0,0,0,0,2,153
2010-01-01,1909,74,19,0,0,0,0,3,96
2010-01-01,1908,41,16,0,0,0,0,1,58
2010-01-01,1907,18,10,0,0,0,0,1,29
2010-01-01,1906,14,13,0,0,0,0,0,27
2010-01-01,1905,12,5,0,0,0,0,0,17
2010-01-01,1904,2,7,0,0,0,0,0,9
2010-01-01,1903,1,3,0,0,0,0,0,4
2010-01-01,1902,2,3,0,0,0,0,0,5
2010-01-01,1901,1,0,0,0,0,0,0,1
2010-01-01,1900,1,1,0,0,0,0,0,2
2010-01-01,1899,0,1,0,0,0,0,0,1
2010-01-01,1898,0,1,0,0,0,0,0,1
2010-07-01,2010,8904,248,0,0,0,0,20,9172
2010-07-01,2009,21146,582,0,0,0,0,117,21845
2010-07-01,2008,23446,633,0,0,0,0,125,24204
2010-07-01,2007,22956,657,0,0,0,0,119,23732
2010-07-01,2006,21770,731,0,0,0,0,173,22674
2010-07-01,2005,20822,681,0,0,0,0,206,21709
2010-07-01,2004,19401,713,0,0,0,0,218,20332
2010-07-01,2003,19913,730,0,0,0,0,175,20818
2010-07-01,2002,18906,731,0,0,0,0,186,19823
2010-07-01,2001,18319,783,0,1,0,0,190,19293
2010-07-01,2000,18773,885,0,0,0,0,187,19845
2010-07-01,1999,17891,830,0,0,0,0,218,18939
2010-07-01,1998,16866,800,0,0,0,0,232,17898
2010-07-01,1997,17219,806,0,0,0,0,243,18268
2010-07-01,1996,17939,918,0,0,0,0,223,19080
2010-07-01,1995,19618,951,0,1,0,0,254,20824
2010-07-01,1994,21581,1017,0,0,0,0,249,22847
2010-07-01,1993,24004,1038,0,3,0,0,279,25324
2010-07-01,1992,28381,1397,0,2,0,0,244,30024
2010-07-01,1991,29352,2071,0,1,0,0,282,31706
2010-07-01,1990,31326,2440,0,5,0,0,353,34124
2010-07-01,1989,31982,2519,0,5,0,0,336,34842
2010-07-01,1988,33422,2669,0,1,0,0,396,36488
2010-07-01,1987,34212,2815,0,2,0,0,508,37537
2010-07-01,1986,34251,2869,0,2,0,0,513,37635
2010-07-01,1985,32907,2915,0,1,0,0,555,36378
2010-07-01,1984,32834,3053,0,1,0,0,585,36473
2010-07-01,1983,32751,3319,0,1,0,0,591,36662
2010-07-01,1982,30485,3106,0,0,0,0,610,34201
2010-07-01,1981,28994,3273,0,3,0,0,570,32840
2010-07-01,1980,28090,3505,0,0,0,0,546,32141
2010-07-01,1979,27173,3601,0,1,0,0,563,31338
2010-07-01,1978,26462,3772,0,1,0,0,574,30809
2010-07-01,1977,26507,3749,0,2,0,0,578,30836
2010-07-01,1976,26967,3658,0,3,0,0,613,31241
2010-07-01,1975,26913,3988,0,4,0,0,648,31553
2010-07-01,1974,26799,4134,0,5,0,0,694,31632
2010-07-01,1973,26545,3924,0,4,0,0,644,31117
2010-07-01,1972,27039,4223,0,6,0,0,713,31981
2010-07-01,1971,27411,4205,0,7,0,0,774,32397
2010-07-01,1970,26742,4187,0,8,0,0,784,31721
2010-07-01,1969,25753,4224,0,8,0,0,736,30721
2010-07-01,1968,25529,4420,0,5,0,0,758,30712
2010-07-01,1967,25048,4725,0,4,0,0,783,30560
2010-07-01,1966,24728,5103,0,3,0,0,745,30579
2010-07-01,1965,23872,5363,0,5,0,0,693,29933
2010-07-01,1964,24885,5933,0,4,0,0,701,31523
2010-07-01,1963,25483,6285,0,6,0,0,689,32463
2010-07-01,1962,26024,6855,0,4,0,0,679,33562
2010-07-01,1961,26551,7100,0,6,0,0,715,34372
2010-07-01,1960,26210,7444,0,5,0,0,691,34350
2010-07-01,1959,25516,7516,0,6,0,0,685,33723
2010-07-01,1958,25125,7643,0,5,0,0,686,33459
2010-07-01,1957,23979,7577,0,5,0,0,689,32250
2010-07-01,1956,22482,7334,0,3,0,0,756,30575
2010-07-01,1955,22064,7333,0,8,0,0,806,30211
2010-07-01,1954,20935,7395,0,1,0,0,966,29297
2010-07-01,1953,19180,6754,0,3,0,0,903,26840
2010-07-01,1952,19323,7094,0,0,0,0,952,27369
2010-07-01,1951,19342,7028,0,2,0,0,922,27294
2010-07-01,1950,18519,6809,0,2,0,0,971,26301
2010-07-01,1949,19200,7514,0,4,0,0,1027,27745
2010-07-01,1948,17861,6835,0,2,0,0,907,25605
2010-07-01,1947,16345,6430,0,1,0,0,901,23677
2010-07-01,1946,14475,5431,0,3,0,0,876,20785
2010-07-01,1945,15170,3670,0,1,0,0,579,19420
2010-07-01,1944,16535,3392,0,1,0,0,540,20468
2010-07-01,1943,18044,3007,0,0,0,0,468,21519
2010-07-01,1942,18665,3893,0,0,0,0,673,23231
2010-07-01,1941,18475,5323,0,0,0,0,994,24792
2010-07-01,1940,17264,5438,0,0,0,0,1118,23820
2010-07-01,1939,16819,5877,0,0,0,0,1215,23911
2010-07-01,1938,16140,5853,0,2,0,0,1212,23207
2010-07-01,1937,14815,6027,0,1,0,0,1320,22163
2010-07-01,1936,14083,4766,0,0,0,0,970,19819
2010-07-01,1935,12895,4075,0,0,0,0,823,17793
2010-07-01,1934,11657,3269,0,0,0,0,642,15568
2010-07-01,1933,11625,3479,0,0,0,0,563,15667
2010-07-01,1932,11573,3771,0,0,0,0,612,15956
2010-07-01,1931,10811,3324,0,0,0,0,645,14780
2010-07-01,1930,10016,3646,0,1,0,0,582,14245
2010-07-01,1929,8950,3189,0,1,0,0,545,12685
2010-07-01,1928,8613,3200,0,0,0,0,505,12318
2010-07-01,1927,7403,2932,0,0,0,0,576,10911
2010-07-01,1926,6303,2506,0,0,0,0,432,9241
2010-07-01,1925,5510,2162,0,0,0,0,377,8049
2010-07-01,1924,4536,1791,0,0,0,0,321,6648
2010-07-01,1923,3949,1553,0,0,0,0,269,5771
2010-07-01,1922,3106,1183,0,0,0,0,210,4499
2010-07-01,1921,2350,834,0,0,0,0,167,3351
2010-07-01,1920,1594,597,0,0,0,0,108,2299
2010-07-01,1919,1188,442,0,0,0,0,68,1698
2010-07-01,1918,964,408,0,0,0,0,61,1433
2010-07-01,1917,556,218,0,0,0,0,28,802
2010-07-01,1916,509,174,0,0,0,0,17,700
2010-07-01,1915,419,160,0,0,0,0,20,599
2010-07-01,1914,410,134,0,0,0,0,19,563
2010-07-01,1913,275,107,0,0,0,0,10,392
2010-07-01,1912,210,81,0,0,0,0,2,293
2010-07-01,1911,132,55,0,0,0,0,3,190
2010-07-01,1910,92,39,0,0,0,0,2,133
2010-07-01,1909,62,15,0,0,0,0,3,80
2010-07-01,1908,32,15,0,0,0,0,1,48
2010-07-01,1907,16,10,0,0,0,0,1,27
2010-07-01,1906,12,13,0,0,0,0,0,25
2010-07-01,1905,11,4,0,0,0,0,0,15
2010-07-01,1904,0,6,0,0,0,0,0,6
2010-07-01,1903,1,3,0,0,0,0,0,4
2010-07-01,1902,1,3,0,0,0,0,0,4
2010-07-01,1901,1,0,0,0,0,0,0,1
2010-07-01,1900,1,1,0,0,0,0,0,2
2010-07-01,1899,0,1,0,0,0,0,0,1
2010-07-01,1898,0,1,0,0,0,0,0,1
2011-01-01,2010,18395,478,0,0,0,0,66,18939
2011-01-01,2009,21202,564,0,0,0,0,139,21905
2011-01-01,2008,23431,610,0,0,0,0,136,24177
2011-01-01,2007,22930,642,0,0,0,0,133,23705
2011-01-01,2006,21726,705,0,0,0,0,187,22618
2011-01-01,2005,20773,657,0,0,0,0,210,21640
2011-01-01,2004,19363,696,0,0,0,0,227,20286
2011-01-01,2003,19874,718,0,0,0,0,183,20775
2011-01-01,2002,18864,719,0,0,0,0,187,19770
2011-01-01,2001,18297,762,0,1,0,0,192,19252
2011-01-01,2000,18757,857,0,0,0,0,188,19802
2011-01-01,1999,17862,809,0,0,0,0,224,18895
2011-01-01,1998,16846,778,0,0,0,0,232,17856
2011-01-01,1997,17195,783,0,0,0,0,246,18224
2011-01-01,1996,17926,886,0,0,0,0,226,19038
2011-01-01,1995,19616,915,0,1,0,0,256,20788
2011-01-01,1994,21569,980,0,0,0,0,263,22812
2011-01-01,1993,24011,991,0,3,0,0,299,25304
2011-01-01,1992,28395,1331,0,1,0,0,259,29986
2011-01-01,1991,29384,1966,0,1,0,0,310,31661
2011-01-01,1990,31366,2286,0,3,0,0,379,34034
2011-01-01,1989,31993,2376,0,5,0,0,381,34755
2011-01-01,1988,33389,2573,0,1,0,0,440,36403
2011-01-01,1987,34151,2712,0,2,0,0,555,37420
2011-01-01,1986,34181,2774,0,2,0,0,548,37505
2011-01-01,1985,32861,2795,0,2,0,0,578,36236
2011-01-01,1984,32716,2949,0,1,0,0,602,36268
2011-01-01,1983,32628,3243,0,1,0,0,610,36482
2011-01-01,1982,30377,3032,0,0,0,0,624,34033
2011-01-01,1981,28900,3204,0,3,0,0,589,32696
2011-01-01,1980,27995,3440,0,0,0,0,578,32013
2011-01-01,1979,27087,3539,0,1,0,0,576,31203
2011-01-01,1978,26376,3705,0,1,0,0,588,30670
2011-01-01,1977,26440,3685,0,3,0,0,600,30728
2011-01-01,1976,26887,3602,0,2,0,0,633,31124
2011-01-01,1975,26823,3940,0,4,0,0,654,31421
2011-01-01,1974,26711,4080,0,4,0,0,704,31499
2011-01-01,1973,26478,3878,0,4,0,0,658,31018
2011-01-01,1972,26948,4179,0,6,0,0,734,31867
2011-01-01,1971,27337,4165,0,6,0,0,791,32299
2011-01-01,1970,26653,4146,0,8,0,0,789,31596
2011-01-01,1969,25685,4185,0,8,0,0,746,30624
2011-01-01,1968,25460,4378,0,5,0,0,766,30609
2011-01-01,1967,24981,4667,0,5,0,0,797,30450
2011-01-01,1966,24649,5039,0,3,0,0,775,30466
2011-01-01,1965,23809,5306,0,6,0,0,718,29839
2011-01-01,1964,24813,5861,0,6,0,0,718,31398
2011-01-01,1963,25404,6208,0,6,0,0,732,32350
2011-01-01,1962,25938,6764,0,4,0,0,719,33425
2011-01-01,1961,26460,6998,0,7,0,0,767,34232
2011-01-01,1960,26103,7332,0,5,0,0,736,34176
2011-01-01,1959,25424,7385,0,6,0,0,758,33573
2011-01-01,1958,25011,7515,0,5,0,0,758,33289
2011-01-01,1957,23860,7407,0,5,0,0,781,32053
2011-01-01,1956,22396,7103,0,3,0,0,907,30409
2011-01-01,1955,21940,7019,0,8,0,0,1051,30018
2011-01-01,1954,20803,7090,0,1,0,0,1202,29096
2011-01-01,1953,19084,6496,0,3,0,0,1120,26703
2011-01-01,1952,19204,6809,0,1,0,0,1157,27171
2011-01-01,1951,19206,6801,0,2,0,0,1069,27078
2011-01-01,1950,18376,6585,0,2,0,0,1117,26080
2011-01-01,1949,19057,7312,0,4,0,0,1142,27515
2011-01-01,1948,17696,6659,0,2,0,0,993,25350
2011-01-01,1947,16165,6234,0,0,0,0,1009,23408
2011-01-01,1946,14352,5275,0,3,0,0,933,20563
2011-01-01,1945,15026,3560,0,1,0,0,624,19211
2011-01-01,1944,16346,3299,0,1,0,0,578,20224
2011-01-01,1943,17824,2919,0,0,0,0,508,21251
2011-01-01,1942,18406,3787,0,0,0,0,715,22908
2011-01-01,1941,18232,5175,0,0,0,0,1057,24464
2011-01-01,1940,16976,5271,0,0,0,0,1173,23420
2011-01-01,1939,16581,5701,0,0,0,0,1263,23545
2011-01-01,1938,15876,5688,0,1,0,0,1250,22815
2011-01-01,1937,14517,5850,0,1,0,0,1357,21725
2011-01-01,1936,13792,4608,0,0,0,0,997,19397
2011-01-01,1935,12609,3966,0,0,0,0,832,17407
2011-01-01,1934,11360,3145,0,0,0,0,662,15167
2011-01-01,1933,11340,3357,0,0,0,0,590,15287
2011-01-01,1932,11220,3657,0,0,0,0,609,15486
2011-01-01,1931,10495,3201,0,0,0,0,648,14344
2011-01-01,1930,9658,3516,0,0,0,0,584,13758
2011-01-01,1929,8625,3039,0,1,0,0,546,12211
2011-01-01,1928,8256,3062,0,0,0,0,502,11820
2011-01-01,1927,7078,2761,0,0,0,0,557,10396
2011-01-01,1926,5992,2372,0,0,0,0,426,8790
2011-01-01,1925,5198,2030,0,0,0,0,369,7597
2011-01-01,1924,4239,1665,0,0,0,0,307,6211
2011-01-01,1923,3702,1427,0,0,0,0,260,5389
2011-01-01,1922,2862,1092,0,0,0,0,197,4151
2011-01-01,1921,2173,769,0,0,0,0,156,3098
2011-01-01,1920,1446,537,0,0,0,0,100,2083
2011-01-01,1919,1060,407,0,0,0,0,58,1525
2011-01-01,1918,863,363,0,0,0,0,57,1283
2011-01-01,1917,494,198,0,0,0,0,24,716
2011-01-01,1916,443,151,0,0,0,0,17,611
2011-01-01,1915,353,143,0,0,0,0,16,512
2011-01-01,1914,348,122,0,0,0,0,19,489
2011-01-01,1913,233,99,0,0,0,0,8,340
2011-01-01,1912,165,76,0,0,0,0,1,242
2011-01-01,1911,116,46,0,0,0,0,1,163
2011-01-01,1910,76,33,0,0,0,0,2,111
2011-01-01,1909,52,15,0,0,0,0,3,70
2011-01-01,1908,26,12,0,0,0,0,1,39
2011-01-01,1907,14,9,0,0,0,0,1,24
2011-01-01,1906,11,10,0,0,0,0,0,21
2011-01-01,1905,9,4,0,0,0,0,0,13
2011-01-01,1904,0,6,0,0,0,0,0,6
2011-01-01,1903,1,3,0,0,0,0,0,4
2011-01-01,1902,1,3,0,0,0,0,0,4
2011-01-01,1900,1,1,0,0,0,0,0,2
2011-01-01,1899,0,1,0,0,0,0,0,1
2011-01-01,1898,0,1,0,0,0,0,0,1
2011-07-01,2011,8455,240,0,0,0,0,31,8726
2011-07-01,2010,19018,462,0,0,0,0,122,19602
2011-07-01,2009,21156,535,0,0,0,0,168,21859
2011-07-01,2008,23355,577,0,0,0,0,144,24076
2011-07-01,2007,22814,610,0,0,0,0,153,23577
2011-07-01,2006,21592,672,0,0,0,0,210,22474
2011-07-01,2005,20660,632,0,0,0,0,222,21514
2011-07-01,2004,19276,675,0,0,0,0,251,20202
2011-07-01,2003,19793,692,0,0,0,0,194,20679
2011-07-01,2002,18804,701,0,0,0,0,198,19703
2011-07-01,2001,18228,743,0,1,0,0,207,19179
2011-07-01,2000,18700,829,0,1,0,0,199,19729
2011-07-01,1999,17818,786,0,0,0,0,237,18841
2011-07-01,1998,16803,759,0,0,0,0,239,17801
2011-07-01,1997,17174,748,0,1,0,0,263,18186
2011-07-01,1996,17905,842,0,0,0,0,232,18979
2011-07-01,1995,19565,897,0,1,0,0,261,20724
2011-07-01,1994,21547,952,0,1,0,0,256,22756
2011-07-01,1993,23971,958,0,3,0,0,293,25225
2011-07-01,1992,28361,1279,0,1,0,0,271,29912
2011-07-01,1991,29292,1856,0,1,0,0,327,31476
2011-07-01,1990,31260,2167,0,4,0,0,422,33853
2011-07-01,1989,31879,2278,0,5,0,0,415,34577
2011-07-01,1988,33247,2467,0,1,0,0,464,36179
2011-07-01,1987,33961,2603,0,2,0,0,574,37140
2011-07-01,1986,33897,2681,0,2,0,0,578,37158
2011-07-01,1985,32607,2698,0,2,0,0,607,35914
2011-07-01,1984,32428,2862,0,1,0,0,615,35906
2011-07-01,1983,32346,3160,0,1,0,0,653,36160
2011-07-01,1982,30101,2968,0,0,0,0,647,33716
2011-07-01,1981,28671,3149,0,3,0,0,601,32424
2011-07-01,1980,27759,3383,0,0,0,0,606,31748
2011-07-01,1979,26850,3491,0,1,0,0,594,30936
2011-07-01,1978,26146,3653,0,1,0,0,611,30411
2011-07-01,1977,26214,3636,0,2,0,0,616,30468
2011-07-01,1976,26746,3537,0,2,0,0,650,30935
2011-07-01,1975,26668,3890,0,3,0,0,686,31247
2011-07-01,1974,26559,4029,0,6,0,0,714,31308
2011-07-01,1973,26349,3834,0,3,0,0,671,30857
2011-07-01,1972,26818,4141,0,7,0,0,749,31715
2011-07-01,1971,27193,4138,0,6,0,0,805,32142
2011-07-01,1970,26551,4095,0,8,0,0,803,31457
2011-07-01,1969,25607,4148,0,8,0,0,756,30519
2011-07-01,1968,25338,4345,0,5,0,0,790,30478
2011-07-01,1967,24893,4630,0,4,0,0,820,30347
2011-07-01,1966,24577,4986,0,3,0,0,798,30364
2011-07-01,1965,23718,5257,0,7,0,0,738,29720
2011-07-01,1964,24718,5801,0,6,0,0,733,31258
2011-07-01,1963,25301,6138,0,6,0,0,764,32209
2011-07-01,1962,25807,6682,0,4,0,0,761,33254
2011-07-01,1961,26347,6922,0,6,0,0,790,34065
2011-07-01,1960,25988,7250,0,5,0,0,753,33996
2011-07-01,1959,25292,7293,0,6,0,0,798,33389
2011-07-01,1958,24905,7414,0,5,0,0,807,33131
2011-07-01,1957,23743,7273,0,5,0,0,850,31871
2011-07-01,1956,22268,6890,0,4,0,0,1040,30202
2011-07-01,1955,21798,6825,0,8,0,0,1197,29828
2011-07-01,1954,20679,6917,0,1,0,0,1305,28902
2011-07-01,1953,18964,6313,0,3,0,0,1206,26486
2011-07-01,1952,19072,6656,0,2,0,0,1236,26966
2011-07-01,1951,19090,6660,0,2,0,0,1129,26881
2011-07-01,1950,18221,6467,0,3,0,0,1163,25854
2011-07-01,1949,18902,7184,0,4,0,0,1178,27268
2011-07-01,1948,17544,6523,0,2,0,0,1032,25101
2011-07-01,1947,15990,6132,0,0,0,0,1040,23162
2011-07-01,1946,14200,5161,0,3,0,0,957,20321
2011-07-01,1945,14838,3477,0,1,0,0,636,18952
2011-07-01,1944,16132,3221,0,1,0,0,591,19945
2011-07-01,1943,17576,2869,0,0,0,0,523,20968
2011-07-01,1942,18108,3713,0,0,0,0,739,22560
2011-07-01,1941,17980,5049,0,0,0,0,1068,24097
2011-07-01,1940,16747,5144,0,0,0,0,1195,23086
2011-07-01,1939,16296,5576,0,0,0,0,1280,23152
2011-07-01,1938,15619,5557,0,1,0,0,1269,22446
2011-07-01,1937,14252,5686,0,1,0,0,1364,21303
2011-07-01,1936,13509,4497,0,0,0,0,1000,19006
2011-07-01,1935,12324,3871,0,0,0,0,825,17020
2011-07-01,1934,11073,3037,0,0,0,0,662,14772
2011-07-01,1933,10962,3247,0,0,0,0,583,14792
2011-07-01,1932,10866,3549,0,0,0,0,598,15013
2011-07-01,1931,10145,3088,0,0,0,0,644,13877
2011-07-01,1930,9300,3367,0,0,0,0,579,13246
2011-07-01,1929,8275,2909,0,1,0,0,530,11715
2011-07-01,1928,7869,2918,0,0,0,0,472,11259
2011-07-01,1927,6721,2607,0,0,0,0,527,9855
2011-07-01,1926,5655,2246,0,0,0,0,404,8305
2011-07-01,1925,4880,1916,0,0,0,0,353,7149
2011-07-01,1924,3982,1553,0,0,0,0,290,5825
2011-07-01,1923,3415,1335,0,0,0,0,238,4988
2011-07-01,1922,2615,977,0,0,0,0,180,3772
2011-07-01,1921,1989,715,0,0,0,0,143,2847
2011-07-01,1920,1294,485,0,0,0,0,93,1872
2011-07-01,1919,938,363,0,0,0,0,54,1355
2011-07-01,1918,750,315,0,0,0,0,50,1115
2011-07-01,1917,434,163,0,0,0,0,20,617
2011-07-01,1916,385,129,0,0,0,0,15,529
2011-07-01,1915,302,129,0,0,0,0,14,445
2011-07-01,1914,288,104,0,0,0,0,15,407
2011-07-01,1913,198,85,0,0,0,0,7,290
2011-07-01,1912,139,68,0,0,0,0,1,208
2011-07-01,1911,100,40,0,0,0,0,2,142
2011-07-01,1910,66,30,0,0,0,0,1,97
2011-07-01,1909,41,15,0,0,0,0,1,57
2011-07-01,1908,21,11,0,0,0,0,1,33
2011-07-01,1907,12,7,0,0,0,0,1,20
2011-07-01,1906,11,10,0,0,0,0,0,21
2011-07-01,1905,9,3,0,0,0,0,0,12
2011-07-01,1904,0,5,0,0,0,0,0,5
2011-07-01,1903,1,3,0,0,0,0,0,4
2011-07-01,1902,1,3,0,0,0,0,0,4
2011-07-01,1900,1,1,0,0,0,0,0,2
2011-07-01,1899,0,1,0,0,0,0,0,1
2011-07-01,1898,0,1,0,0,0,0,0,1
2012-01-01,2011,17919,397,0,0,0,0,92,18408
2012-01-01,2010,19183,438,0,0,0,0,164,19785
2012-01-01,2009,21164,508,0,0,0,0,204,21876
2012-01-01,2008,23297,563,0,0,0,0,182,24042
2012-01-01,2007,22710,594,0,0,0,0,190,23494
2012-01-01,2006,21514,645,0,0,0,0,241,22400
2012-01-01,2005,20597,605,0,0,0,0,260,21462
2012-01-01,2004,19228,656,0,0,0,0,276,20160
2012-01-01,2003,19734,662,0,0,0,0,228,20624
2012-01-01,2002,18766,682,0,0,0,0,222,19670
2012-01-01,2001,18181,716,0,1,0,0,221,19119
2012-01-01,2000,18657,812,0,1,0,0,218,19688
2012-01-01,1999,17765,769,0,0,0,0,257,18791
2012-01-01,1998,16767,729,0,0,0,0,254,17750
2012-01-01,1997,17146,710,0,1,0,0,299,18156
2012-01-01,1996,17911,805,0,0,0,0,255,18971
2012-01-01,1995,19562,829,0,1,0,0,280,20672
2012-01-01,1994,21563,887,0,1,0,0,282,22733
2012-01-01,1993,23948,915,0,2,0,0,332,25197
2012-01-01,1992,28311,1224,0,1,0,0,351,29887
2012-01-01,1991,29308,1709,0,1,0,0,426,31444
2012-01-01,1990,31244,2041,0,4,0,0,454,33743
2012-01-01,1989,31825,2197,0,5,0,0,460,34487
2012-01-01,1988,33159,2380,0,1,0,0,517,36057
2012-01-01,1987,33841,2518,0,2,0,0,617,36978
2012-01-01,1986,33808,2603,0,2,0,0,620,37033
2012-01-01,1985,32476,2609,0,2,0,0,634,35721
2012-01-01,1984,32248,2802,0,1,0,0,655,35706
2012-01-01,1983,32157,3098,0,1,0,0,716,35972
2012-01-01,1982,29900,2905,0,0,0,0,666,33471
2012-01-01,1981,28550,3081,0,3,0,0,641,32275
2012-01-01,1980,27607,3328,0,0,0,0,649,31584
2012-01-01,1979,26737,3437,0,0,0,0,614,30788
2012-01-01,1978,26031,3596,0,1,0,0,653,30281
2012-01-01,1977,26073,3586,0,2,0,0,661,30322
2012-01-01,1976,26640,3486,0,2,0,0,682,30810
2012-01-01,1975,26560,3836,0,3,0,0,732,31131
2012-01-01,1974,26468,3984,0,6,0,0,766,31224
2012-01-01,1973,26249,3797,0,3,0,0,724,30773
2012-01-01,1972,26729,4111,0,6,0,0,785,31631
2012-01-01,1971,27069,4106,0,6,0,0,841,32022
2012-01-01,1970,26468,4063,0,7,0,0,838,31376
2012-01-01,1969,25506,4112,0,8,0,0,801,30427
2012-01-01,1968,25272,4307,0,5,0,0,819,30403
2012-01-01,1967,24833,4577,0,5,0,0,841,30256
2012-01-01,1966,24503,4947,0,3,0,0,822,30275
2012-01-01,1965,23643,5188,0,7,0,0,785,29623
2012-01-01,1964,24638,5750,0,6,0,0,775,31169
2012-01-01,1963,25214,6062,0,6,0,0,816,32098
2012-01-01,1962,25714,6616,0,3,0,0,794,33127
2012-01-01,1961,26247,6848,0,7,0,0,825,33927
2012-01-01,1960,25891,7181,0,5,0,0,792,33869
2012-01-01,1959,25200,7195,0,6,0,0,853,33254
2012-01-01,1958,24807,7289,0,5,0,0,882,32983
2012-01-01,1957,23644,7101,0,6,0,0,966,31717
2012-01-01,1956,22153,6618,0,5,0,0,1259,30035
2012-01-01,1955,21680,6597,0,8,0,0,1358,29643
2012-01-01,1954,20573,6721,0,1,0,0,1421,28716
2012-01-01,1953,18838,6153,0,3,0,0,1308,26302
2012-01-01,1952,18967,6494,0,2,0,0,1323,26786
2012-01-01,1951,18972,6539,0,2,0,0,1186,26699
2012-01-01,1950,18117,6388,0,3,0,0,1183,25691
2012-01-01,1949,18762,7089,0,3,0,0,1199,27053
2012-01-01,1948,17409,6418,0,2,0,0,1048,24877
2012-01-01,1947,15845,6047,0,0,0,0,1053,22945
2012-01-01,1946,14072,5074,0,3,0,0,972,20121
2012-01-01,1945,14680,3425,0,1,0,0,640,18746
2012-01-01,1944,15947,3161,0,1,0,0,597,19706
2012-01-01,1943,17358,2823,0,0,0,0,536,20717
2012-01-01,1942,17876,3646,0,0,0,0,742,22264
2012-01-01,1941,17751,4948,0,0,0,0,1061,23760
2012-01-01,1940,16492,5039,0,0,0,0,1203,22734
2012-01-01,1939,16037,5460,0,0,0,0,1277,22774
2012-01-01,1938,15366,5444,0,1,0,0,1262,22073
2012-01-01,1937,14001,5555,0,0,0,0,1346,20902
2012-01-01,1936,13235,4391,0,0,0,0,988,18614
2012-01-01,1935,12062,3764,0,0,0,0,813,16639
2012-01-01,1934,10819,2950,0,0,0,0,656,14425
2012-01-01,1933,10664,3145,0,0,0,0,575,14384
2012-01-01,1932,10564,3420,0,0,0,0,587,14571
2012-01-01,1931,9835,2993,0,0,0,0,627,13455
2012-01-01,1930,8976,3255,0,0,0,0,566,12797
2012-01-01,1929,7956,2789,0,0,0,0,512,11257
2012-01-01,1928,7546,2792,0,0,0,0,457,10795
2012-01-01,1927,6408,2482,0,0,0,0,514,9404
2012-01-01,1926,5361,2121,0,0,0,0,384,7866
2012-01-01,1925,4608,1792,0,0,0,0,338,6738
2012-01-01,1924,3744,1480,0,0,0,0,274,5498
2012-01-01,1923,3210,1247,0,0,0,0,220,4677
2012-01-01,1922,2423,902,0,0,0,0,162,3487
2012-01-01,1921,1828,658,0,0,0,0,132,2618
2012-01-01,1920,1177,451,0,0,0,0,80,1708
2012-01-01,1919,860,341,0,0,0,0,49,1250
2012-01-01,1918,666,283,0,0,0,0,47,996
2012-01-01,1917,369,138,0,0,0,0,16,523
2012-01-01,1916,333,116,0,0,0,0,11,460
2012-01-01,1915,258,112,0,0,0,0,15,385
2012-01-01,1914,248,89,0,0,0,0,13,350
2012-01-01,1913,169,79,0,0,0,0,6,254
2012-01-01,1912,119,62,0,0,0,0,1,182
2012-01-01,1911,84,35,0,0,0,0,0,119
2012-01-01,1910,54,26,0,0,0,0,0,80
2012-01-01,1909,37,14,0,0,0,0,1,52
2012-01-01,1908,21,10,0,0,0,0,1,32
2012-01-01,1907,9,7,0,0,0,0,1,17
2012-01-01,1906,10,10,0,0,0,0,0,20
2012-01-01,1905,8,0,0,0,0,0,0,8
2012-01-01,1904,0,1,0,0,0,0,0,1
2012-01-01,1903,1,1,0,0,0,0,0,2
2012-01-01,1902,1,0,0,0,0,0,0,1
2012-01-01,1899,0,1,0,0,0,0,0,1
2012-01-01,1898,0,1,0,0,0,0,0,1
2012-07-01,2012,8955,149,0,0,0,0,35,9139
2012-07-01,2011,18580,370,1,0,2,0,145,19098
2012-07-01,2010,19213,419,1,0,0,0,188,19821
2012-07-01,2009,21169,482,1,0,1,0,235,21888
2012-07-01,2008,23236,543,1,0,0,0,209,23989
2012-07-01,2007,22616,571,0,0,0,0,223,23410
2012-07-01,2006,21429,625,1,0,0,0,272,22327
2012-07-01,2005,20549,582,0,0,1,0,279,21411
2012-07-01,2004,19183,625,1,0,0,0,297,20106
2012-07-01,2003,19701,637,1,0,2,0,257,20598
2012-07-01,2002,18726,662,0,0,0,0,256,19644
2012-07-01,2001,18130,689,0,1,0,0,249,19069
2012-07-01,2000,18611,783,1,1,1,0,227,19624
2012-07-01,1999,17745,741,0,0,0,0,280,18766
2012-07-01,1998,16749,683,1,0,0,0,277,17710
2012-07-01,1997,17149,650,1,0,2,0,313,18115
2012-07-01,1996,17874,785,0,0,0,0,271,18930
2012-07-01,1995,19539,785,1,1,2,0,277,20605
2012-07-01,1994,21574,822,2,1,1,0,279,22679
2012-07-01,1993,23925,867,1,2,0,0,352,25147
2012-07-01,1992,28265,1170,1,1,1,0,405,29843
2012-07-01,1991,29242,1633,3,1,0,0,464,31343
2012-07-01,1990,31181,1969,2,4,0,0,489,33645
2012-07-01,1989,31773,2117,1,6,0,0,507,34404
2012-07-01,1988,33080,2307,3,1,0,0,560,35951
2012-07-01,1987,33705,2432,2,2,0,0,672,36813
2012-07-01,1986,33662,2514,0,2,0,0,654,36832
2012-07-01,1985,32318,2537,3,2,1,0,678,35539
2012-07-01,1984,32112,2722,1,1,0,0,690,35526
2012-07-01,1983,31973,3038,2,1,0,0,765,35779
2012-07-01,1982,29729,2839,4,0,1,0,707,33280
2012-07-01,1981,28373,3005,1,3,1,0,679,32062
2012-07-01,1980,27445,3267,3,0,1,0,668,31384
2012-07-01,1979,26590,3383,3,0,1,0,655,30632
2012-07-01,1978,25888,3547,2,1,0,0,690,30128
2012-07-01,1977,25933,3539,3,2,1,0,688,30166
2012-07-01,1976,26519,3447,2,2,0,0,710,30680
2012-07-01,1975,26426,3789,1,3,0,0,754,30973
2012-07-01,1974,26370,3935,0,5,2,0,814,31126
2012-07-01,1973,26145,3752,0,3,1,0,761,30662
2012-07-01,1972,26631,4056,1,6,2,0,829,31525
2012-07-01,1971,26955,4059,1,6,0,0,886,31907
2012-07-01,1970,26374,4016,0,7,2,0,871,31270
2012-07-01,1969,25418,4075,1,8,0,0,849,30351
2012-07-01,1968,25175,4273,1,5,0,0,848,30302
2012-07-01,1967,24759,4530,0,5,1,0,861,30156
2012-07-01,1966,24410,4901,1,4,0,0,843,30159
2012-07-01,1965,23543,5133,0,7,0,0,825,29508
2012-07-01,1964,24563,5692,0,6,1,0,791,31053
2012-07-01,1963,25135,5981,0,7,0,0,867,31990
2012-07-01,1962,25607,6564,0,4,0,0,850,33025
2012-07-01,1961,26137,6777,0,7,1,0,857,33779
2012-07-01,1960,25806,7084,0,5,0,0,853,33748
2012-07-01,1959,25072,7068,0,6,0,0,913,33059
2012-07-01,1958,24697,7134,0,5,0,0,948,32784
2012-07-01,1957,23530,6831,1,6,0,0,1164,31532
2012-07-01,1956,22033,6387,0,5,0,0,1417,29842
2012-07-01,1955,21563,6415,0,8,1,0,1462,29449
2012-07-01,1954,20444,6528,0,1,1,0,1498,28472
2012-07-01,1953,18731,6005,0,3,0,0,1388,26127
2012-07-01,1952,18862,6357,0,2,2,0,1384,26607
2012-07-01,1951,18844,6412,0,1,0,0,1217,26474
2012-07-01,1950,17970,6290,0,3,0,0,1205,25468
2012-07-01,1949,18581,6968,0,4,0,0,1229,26782
2012-07-01,1948,17258,6326,0,2,0,0,1052,24638
2012-07-01,1947,15668,5959,0,0,0,0,1056,22683
2012-07-01,1946,13933,4994,0,2,0,0,983,19912
2012-07-01,1945,14532,3378,0,1,0,0,640,18551
2012-07-01,1944,15762,3100,0,1,0,0,600,19463
2012-07-01,1943,17127,2785,0,0,0,0,539,20451
2012-07-01,1942,17622,3587,0,0,0,0,736,21945
2012-07-01,1941,17476,4841,0,0,0,0,1056,23373
2012-07-01,1940,16248,4947,0,0,0,0,1189,22384
2012-07-01,1939,15767,5346,0,0,0,0,1264,22377
2012-07-01,1938,15057,5315,0,2,0,0,1249,21623
2012-07-01,1937,13738,5437,0,0,0,0,1329,20504
2012-07-01,1936,12914,4271,0,0,0,0,987,18172
2012-07-01,1935,11783,3658,0,0,0,0,803,16244
2012-07-01,1934,10511,2861,0,0,0,0,641,14013
2012-07-01,1933,10356,3039,0,0,0,0,565,13960
2012-07-01,1932,10176,3290,0,0,0,0,575,14041
2012-07-01,1931,9450,2863,0,0,0,0,598,12911
2012-07-01,1930,8600,3123,0,0,0,0,549,12272
2012-07-01,1929,7599,2645,0,0,0,0,487,10731
2012-07-01,1928,7171,2646,0,0,0,0,438,10255
2012-07-01,1927,6051,2334,0,0,0,0,500,8885
2012-07-01,1926,5018,1986,0,0,0,0,365,7369
2012-07-01,1925,4272,1666,0,0,0,0,319,6257
2012-07-01,1924,3467,1349,0,0,0,0,255,5071
2012-07-01,1923,2952,1147,0,0,0,0,206,4305
2012-07-01,1922,2202,812,0,0,0,0,145,3159
2012-07-01,1921,1647,579,0,0,0,0,122,2348
2012-07-01,1920,1054,400,0,0,0,0,74,1528
2012-07-01,1919,749,305,0,0,0,0,41,1095
2012-07-01,1918,570,253,0,0,0,0,41,864
2012-07-01,1917,319,118,0,0,0,0,15,452
2012-07-01,1916,276,103,0,0,0,0,11,390
2012-07-01,1915,214,98,0,0,0,0,15,327
2012-07-01,1914,211,77,0,0,0,0,11,299
2012-07-01,1913,133,70,0,0,0,0,6,209
2012-07-01,1912,97,50,0,0,0,0,1,148
2012-07-01,1911,69,32,0,0,0,0,0,101
2012-07-01,1910,46,25,0,0,0,0,0,71
2012-07-01,1909,28,14,0,0,0,0,0,42
2012-07-01,1908,18,9,0,0,0,0,1,28
2012-07-01,1907,8,7,0,0,0,0,1,16
2012-07-01,1906,7,10,0,0,0,0,0,17
2012-07-01,1905,7,0,0,0,0,0,0,7
2012-07-01,1904,0,1,0,0,0,0,0,1
2012-07-01,1903,0,1,0,0,0,0,0,1
2012-07-01,1902,1,0,0,0,0,0,0,1
2012-07-01,1898,0,1,0,0,0,0,0,1
2013-01-01,2012,19032,260,0,0,0,0,122,19414
2013-01-01,2011,18763,359,1,0,2,0,186,19311
2013-01-01,2010,19276,401,1,0,0,0,232,19910
2013-01-01,2009,21132,469,1,0,2,0,271,21875
2013-01-01,2008,23159,518,1,0,0,0,244,23922
2013-01-01,2007,22524,549,0,0,0,0,263,23336
2013-01-01,2006,21363,599,1,0,0,0,312,22275
2013-01-01,2005,20487,558,0,0,1,0,303,21349
2013-01-01,2004,19135,600,1,0,0,0,328,20064
2013-01-01,2003,19637,609,1,0,2,0,283,20532
2013-01-01,2002,18671,632,0,0,0,0,274,19577
2013-01-01,2001,18077,656,0,1,0,0,279,19013
2013-01-01,2000,18602,750,1,1,1,0,243,19598
2013-01-01,1999,17724,705,0,0,0,0,297,18726
2013-01-01,1998,16735,625,1,0,0,0,289,17650
2013-01-01,1997,17121,603,1,0,2,0,347,18074
2013-01-01,1996,17853,738,0,0,0,0,291,18882
2013-01-01,1995,19515,744,1,1,2,0,327,20590
2013-01-01,1994,21566,773,1,1,1,0,313,22655
2013-01-01,1993,23893,825,2,2,0,0,458,25180
2013-01-01,1992,28183,1104,1,1,1,0,506,29796
2013-01-01,1991,29215,1560,2,1,0,0,540,31318
2013-01-01,1990,31099,1923,2,4,0,0,580,33608
2013-01-01,1989,31690,2050,1,6,0,0,570,34317
2013-01-01,1988,32967,2250,3,1,0,0,610,35831
2013-01-01,1987,33515,2379,2,1,0,0,718,36615
2013-01-01,1986,33458,2453,1,2,0,0,730,36644
2013-01-01,1985,32145,2480,4,1,2,0,744,35376
2013-01-01,1984,31932,2663,3,1,0,0,720,35319
2013-01-01,1983,31789,2968,2,1,1,0,820,35581
2013-01-01,1982,29535,2791,5,0,1,0,750,33082
2013-01-01,1981,28177,2950,1,3,1,0,737,31869
2013-01-01,1980,27304,3212,3,0,2,0,711,31232
2013-01-01,1979,26464,3331,3,0,1,0,713,30512
2013-01-01,1978,25744,3497,2,1,0,0,730,29974
2013-01-01,1977,25799,3492,3,2,2,0,735,30033
2013-01-01,1976,26367,3397,2,2,1,0,764,30533
2013-01-01,1975,26304,3753,2,3,0,0,799,30861
2013-01-01,1974,26261,3895,0,5,3,0,866,31030
2013-01-01,1973,26034,3711,0,3,1,0,804,30553
2013-01-01,1972,26503,4020,2,6,2,0,892,31425
2013-01-01,1971,26848,4019,1,6,0,0,946,31820
2013-01-01,1970,26279,3970,0,7,2,0,902,31160
2013-01-01,1969,25315,4044,1,8,0,0,910,30278
2013-01-01,1968,25099,4230,1,5,0,0,912,30247
2013-01-01,1967,24641,4484,0,5,2,0,900,30032
2013-01-01,1966,24336,4853,1,4,0,0,879,30073
2013-01-01,1965,23462,5086,0,7,0,0,861,29416
2013-01-01,1964,24457,5637,0,6,1,0,839,30940
2013-01-01,1963,25042,5898,0,6,0,0,913,31859
2013-01-01,1962,25501,6482,0,5,0,0,911,32899
2013-01-01,1961,26041,6667,0,7,1,0,927,33643
2013-01-01,1960,25702,6963,0,6,0,0,922,33593
2013-01-01,1959,24951,6934,0,5,0,0,1028,32918
2013-01-01,1958,24590,6920,0,5,0,0,1110,32625
2013-01-01,1957,23388,6506,1,6,0,0,1431,31332
2013-01-01,1956,21910,6162,0,6,0,0,1608,29686
2013-01-01,1955,21444,6207,0,8,1,0,1628,29288
2013-01-01,1954,20325,6356,0,1,1,0,1618,28301
2013-01-01,1953,18625,5887,0,3,0,0,1480,25995
2013-01-01,1952,18767,6210,0,2,2,0,1463,26444
2013-01-01,1951,18710,6304,0,1,0,0,1242,26257
2013-01-01,1950,17822,6212,0,4,0,0,1233,25271
2013-01-01,1949,18426,6875,0,4,0,0,1242,26547
2013-01-01,1948,17127,6237,0,2,0,0,1062,24428
2013-01-01,1947,15515,5887,0,0,0,0,1064,22466
2013-01-01,1946,13793,4911,0,2,0,0,984,19690
2013-01-01,1945,14374,3322,0,1,0,0,643,18340
2013-01-01,1944,15566,3045,0,1,0,0,601,19213
2013-01-01,1943,16901,2727,0,0,0,0,540,20168
2013-01-01,1942,17405,3518,0,0,0,0,739,21662
2013-01-01,1941,17246,4767,0,0,0,0,1056,23069
2013-01-01,1940,16016,4845,0,0,0,0,1184,22045
2013-01-01,1939,15515,5227,0,0,0,0,1262,22004
2013-01-01,1938,14781,5195,0,2,0,0,1239,21217
2013-01-01,1937,13476,5324,0,0,0,0,1313,20113
2013-01-01,1936,12668,4177,0,0,0,0,977,17822
2013-01-01,1935,11528,3570,0,0,0,0,795,15893
2013-01-01,1934,10238,2763,0,0,0,0,633,13634
2013-01-01,1933,10065,2931,0,0,0,0,554,13550
2013-01-01,1932,9843,3177,0,0,0,0,570,13590
2013-01-01,1931,9097,2764,0,0,0,0,588,12449
2013-01-01,1930,8258,2999,0,0,0,0,531,11788
2013-01-01,1929,7305,2528,0,0,0,0,462,10295
2013-01-01,1928,6840,2515,0,0,0,0,425,9780
2013-01-01,1927,5736,2215,0,0,0,0,478,8429
2013-01-01,1926,4712,1877,0,0,0,0,342,6931
2013-01-01,1925,3984,1561,0,0,0,0,300,5845
2013-01-01,1924,3235,1259,0,0,0,0,243,4737
2013-01-01,1923,2716,1074,0,0,0,0,191,3981
2013-01-01,1922,2005,744,0,0,0,0,135,2884
2013-01-01,1921,1504,529,0,0,0,0,117,2150
2013-01-01,1920,941,365,0,0,0,0,69,1375
2013-01-01,1919,671,274,0,0,0,0,36,981
2013-01-01,1918,483,229,0,0,0,0,36,748
2013-01-01,1917,279,108,0,0,0,0,14,401
2013-01-01,1916,237,91,0,0,0,0,10,338
2013-01-01,1915,177,94,0,0,0,0,12,283
2013-01-01,1914,187,74,0,0,0,0,9,270
2013-01-01,1913,112,65,0,0,0,0,6,183
2013-01-01,1912,76,47,0,0,0,0,1,124
2013-01-01,1911,57,28,0,0,0,0,0,85
2013-01-01,1910,40,23,0,0,0,0,0,63
2013-01-01,1909,26,12,0,0,0,0,0,38
2013-01-01,1908,18,8,0,0,0,0,0,26
2013-01-01,1907,7,7,0,0,0,0,1,15
2013-01-01,1906,7,9,0,0,0,0,0,16
2013-01-01,1905,7,0,0,0,0,0,0,7
2013-01-01,1904,0,1,0,0,0,0,0,1
2013-01-01,1903,0,1,0,0,0,0,0,1
2013-01-01,1902,1,0,0,0,0,0,0,1
2013-01-01,1898,0,1,0,0,0,0,0,1
2013-07-01,2013,9166,112,0,0,0,0,38,9316
2013-07-01,2012,19857,250,1,0,0,0,226,20334
2013-07-01,2011,18828,346,1,0,2,0,228,19405
2013-07-01,2010,19315,382,1,0,1,0,271,19970
2013-07-01,2009,21119,447,3,0,2,0,295,21866
2013-07-01,2008,23075,491,1,0,0,0,288,23855
2013-07-01,2007,22404,530,0,0,0,0,302,23236
2013-07-01,2006,21320,568,1,0,1,0,337,22227
2013-07-01,2005,20424,533,0,0,1,0,334,21292
2013-07-01,2004,19093,570,1,0,0,0,348,20012
2013-07-01,2003,19561,583,1,0,2,0,310,20457
2013-07-01,2002,18606,600,0,0,0,0,311,19517
2013-07-01,2001,18028,626,0,1,0,0,316,18971
2013-07-01,2000,18558,728,1,0,1,0,274,19562
2013-07-01,1999,17698,656,0,0,1,0,323,18678
2013-07-01,1998,16719,566,1,0,0,0,304,17590
2013-07-01,1997,17062,587,1,0,2,0,364,18016
2013-07-01,1996,17822,709,0,0,0,0,306,18837
2013-07-01,1995,19496,713,1,1,2,0,315,20528
2013-07-01,1994,21526,743,2,1,1,0,351,22624
2013-07-01,1993,23828,799,3,2,0,0,521,25153
2013-07-01,1992,28057,1071,1,1,2,0,554,29686
2013-07-01,1991,29094,1514,4,1,0,0,570,31183
2013-07-01,1990,30970,1872,2,4,0,0,590,33438
2013-07-01,1989,31526,2004,2,6,0,0,614,34152
2013-07-01,1988,32737,2204,5,1,0,0,650,35597
2013-07-01,1987,33081,2325,2,1,0,0,754,36163
2013-07-01,1986,33024,2407,2,2,1,0,775,36211
2013-07-01,1985,31754,2427,4,1,2,0,783,34971
2013-07-01,1984,31497,2612,3,1,0,0,766,34879
2013-07-01,1983,31369,2915,3,1,1,0,854,35143
2013-07-01,1982,29153,2749,6,0,1,0,791,32700
2013-07-01,1981,27909,2908,1,3,1,0,781,31603
2013-07-01,1980,27077,3154,3,0,2,0,766,31002
2013-07-01,1979,26291,3283,3,1,1,0,764,30343
2013-07-01,1978,25527,3455,3,1,0,0,788,29774
2013-07-01,1977,25576,3458,3,2,3,0,792,29834
2013-07-01,1976,26119,3365,2,2,1,0,801,30290
2013-07-01,1975,26126,3716,3,3,0,0,838,30686
2013-07-01,1974,26090,3848,0,5,3,0,919,30865
2013-07-01,1973,25867,3674,0,3,1,0,852,30397
2013-07-01,1972,26354,3966,2,6,3,0,974,31305
2013-07-01,1971,26682,3967,2,7,0,0,1003,31661
2013-07-01,1970,26128,3928,1,7,3,0,970,31037
2013-07-01,1969,25158,4007,1,8,0,0,958,30132
2013-07-01,1968,24964,4194,1,5,0,0,965,30129
2013-07-01,1967,24505,4441,0,5,2,0,938,29891
2013-07-01,1966,24205,4788,2,4,0,0,928,29927
2013-07-01,1965,23322,5030,1,5,0,0,911,29269
2013-07-01,1964,24340,5555,0,6,1,0,897,30799
2013-07-01,1963,24909,5823,1,6,0,0,975,31714
2013-07-01,1962,25380,6394,0,5,0,0,971,32750
2013-07-01,1961,25872,6554,0,7,1,0,1016,33450
2013-07-01,1960,25559,6831,1,8,0,0,987,33386
2013-07-01,1959,24795,6758,0,5,0,0,1145,32703
2013-07-01,1958,24442,6625,0,5,0,0,1326,32398
2013-07-01,1957,23227,6262,0,6,0,0,1647,31142
2013-07-01,1956,21770,5975,0,6,1,0,1750,29502
2013-07-01,1955,21296,5999,0,8,0,0,1764,29067
2013-07-01,1954,20180,6162,0,1,1,0,1756,28100
2013-07-01,1953,18486,5733,0,3,0,0,1567,25789
2013-07-01,1952,18592,6092,0,2,2,0,1531,26219
2013-07-01,1951,18555,6198,0,1,0,0,1282,26036
2013-07-01,1950,17640,6099,0,5,0,0,1262,25006
2013-07-01,1949,18240,6778,0,3,0,0,1250,26271
2013-07-01,1948,16941,6139,0,2,0,0,1072,24154
2013-07-01,1947,15339,5786,0,0,0,0,1072,22197
2013-07-01,1946,13621,4833,0,2,0,0,1006,19462
2013-07-01,1945,14184,3261,0,1,0,0,648,18094
2013-07-01,1944,15375,2980,0,1,0,0,606,18962
2013-07-01,1943,16640,2668,0,0,0,0,540,19848
2013-07-01,1942,17120,3449,0,0,0,0,735,21304
2013-07-01,1941,16950,4669,0,0,0,0,1053,22672
2013-07-01,1940,15727,4738,0,0,0,0,1184,21649
2013-07-01,1939,15200,5096,0,0,0,0,1245,21541
2013-07-01,1938,14455,5060,0,2,0,0,1223,20740
2013-07-01,1937,13173,5159,0,0,0,0,1292,19624
2013-07-01,1936,12333,4055,0,0,0,0,964,17352
2013-07-01,1935,11229,3447,0,0,0,0,793,15469
2013-07-01,1934,9927,2647,0,0,0,0,616,13190
2013-07-01,1933,9726,2817,0,0,0,0,540,13083
2013-07-01,1932,9429,3050,0,0,0,0,559,13038
2013-07-01,1931,8726,2662,0,0,0,0,571,11959
2013-07-01,1930,7909,2840,0,0,0,0,512,11261
2013-07-01,1929,6887,2369,0,0,0,0,450,9706
2013-07-01,1928,6447,2353,0,0,0,0,406,9206
2013-07-01,1927,5388,2063,0,0,0,0,445,7896
2013-07-01,1926,4364,1730,0,0,0,0,328,6422
2013-07-01,1925,3623,1412,0,0,0,0,282,5317
2013-07-01,1924,2993,1159,0,0,0,0,225,4377
2013-07-01,1923,2466,958,0,0,0,0,169,3593
2013-07-01,1922,1774,681,0,0,0,0,124,2579
2013-07-01,1921,1312,466,0,0,0,0,107,1885
2013-07-01,1920,828,332,0,0,0,0,60,1220
2013-07-01,1919,563,249,0,0,0,0,32,844
2013-07-01,1918,415,202,0,0,0,0,30,647
2013-07-01,1917,242,92,0,0,0,0,10,344
2013-07-01,1916,187,84,0,0,0,0,9,280
2013-07-01,1915,149,85,0,0,0,0,13,247
2013-07-01,1914,148,71,0,0,0,0,7,226
2013-07-01,1913,88,60,0,0,0,0,4,152
2013-07-01,1912,58,45,0,0,0,0,1,104
2013-07-01,1911,48,25,0,0,0,0,0,73
2013-07-01,1910,37,22,0,0,0,0,0,59
2013-07-01,1909,24,12,0,0,0,0,0,36
2013-07-01,1908,16,6,0,0,0,0,0,22
2013-07-01,1907,6,7,0,0,0,0,1,14
2013-07-01,1906,7,9,0,0,0,0,0,16
2013-07-01,1905,5,0,0,0,0,0,0,5
2013-07-01,1904,0,1,0,0,0,0,0,1
2013-07-01,1903,1,1,0,0,0,0,0,2
2013-07-01,1902,1,0,0,0,0,0,0,1
2013-07-01,1898,0,1,0,0,0,0,0,1
2014-01-01,2013,19881,186,0,0,0,0,167,20234
2014-01-01,2012,20074,239,1,0,0,0,315,20629
2014-01-01,2011,18922,333,1,0,2,0,288,19546
2014-01-01,2010,19342,373,1,0,1,0,319,20036
2014-01-01,2009,21056,432,3,0,2,0,355,21848
2014-01-01,2008,23010,479,1,0,0,0,337,23827
2014-01-01,2007,22316,511,0,0,0,0,343,23170
2014-01-01,2006,21251,548,1,0,1,0,383,22184
2014-01-01,2005,20370,526,0,0,1,0,389,21286
2014-01-01,2004,19013,556,1,0,0,0,399,19969
2014-01-01,2003,19435,568,1,0,2,0,359,20365
2014-01-01,2002,18516,578,0,0,0,0,354,19448
2014-01-01,2001,17967,598,0,1,0,0,354,18920
2014-01-01,2000,18516,699,1,0,1,0,317,19534
2014-01-01,1999,17664,608,0,0,1,0,360,18633
2014-01-01,1998,16682,536,1,0,0,0,353,17572
2014-01-01,1997,17028,550,1,0,2,0,396,17977
2014-01-01,1996,17805,669,0,0,0,0,351,18825
2014-01-01,1995,19476,679,1,1,2,0,394,20553
2014-01-01,1994,21451,711,2,1,1,0,504,22670
2014-01-01,1993,23712,752,3,2,0,0,686,25155
2014-01-01,1992,27943,1030,1,1,2,0,648,29625
2014-01-01,1991,28949,1477,4,1,0,0,650,31081
2014-01-01,1990,30791,1819,2,4,0,0,661,33277
2014-01-01,1989,31322,1933,2,6,0,0,655,33918
2014-01-01,1988,32450,2149,6,1,0,0,685,35291
2014-01-01,1987,32617,2274,2,1,1,0,803,35698
2014-01-01,1986,32691,2357,2,1,1,0,818,35870
2014-01-01,1985,31369,2380,5,1,2,0,838,34595
2014-01-01,1984,31075,2563,5,1,0,0,839,34483
2014-01-01,1983,30990,2868,3,1,1,0,921,34784
2014-01-01,1982,28757,2691,7,0,1,0,854,32310
2014-01-01,1981,27640,2856,1,3,1,0,834,31335
2014-01-01,1980,26865,3102,3,0,3,0,839,30812
2014-01-01,1979,26093,3217,3,1,1,0,839,30154
2014-01-01,1978,25303,3422,4,1,0,0,863,29593
2014-01-01,1977,25348,3421,3,2,3,0,877,29654
2014-01-01,1976,25890,3323,2,2,1,0,852,30070
2014-01-01,1975,25921,3682,3,3,0,0,935,30544
2014-01-01,1974,25900,3804,0,5,3,0,1017,30729
2014-01-01,1973,25707,3634,0,3,2,0,938,30284
2014-01-01,1972,26197,3926,2,6,3,0,1062,31196
2014-01-01,1971,26497,3930,2,7,1,0,1103,31540
2014-01-01,1970,25949,3886,1,7,3,0,1056,30902
2014-01-01,1969,25014,3955,1,8,0,0,1034,30012
2014-01-01,1968,24800,4156,1,5,0,0,1029,29991
2014-01-01,1967,24387,4392,0,5,2,0,1015,29801
2014-01-01,1966,24080,4739,2,4,0,0,1009,29834
2014-01-01,1965,23194,4979,1,5,0,0,970,29149
2014-01-01,1964,24211,5491,0,6,1,0,966,30675
2014-01-01,1963,24746,5752,1,6,0,0,1045,31550
2014-01-01,1962,25228,6298,0,5,0,0,1063,32594
2014-01-01,1961,25723,6459,0,7,1,0,1094,33284
2014-01-01,1960,25397,6700,1,8,0,0,1087,33193
2014-01-01,1959,24656,6548,0,5,0,0,1316,32525
2014-01-01,1958,24274,6305,0,5,0,0,1632,32216
2014-01-01,1957,23083,6024,0,6,0,0,1863,30976
2014-01-01,1956,21611,5786,0,6,2,0,1898,29303
2014-01-01,1955,21156,5817,0,8,0,0,1913,28894
2014-01-01,1954,20036,5987,0,1,1,0,1883,27908
2014-01-01,1953,18346,5598,0,3,0,0,1674,25621
2014-01-01,1952,18468,5968,0,1,2,0,1595,26034
2014-01-01,1951,18428,6108,0,2,0,0,1314,25852
2014-01-01,1950,17491,5999,0,5,0,0,1288,24783
2014-01-01,1949,18100,6687,0,3,0,0,1279,26069
2014-01-01,1948,16763,6049,0,2,0,0,1093,23907
2014-01-01,1947,15175,5719,0,0,0,0,1089,21983
2014-01-01,1946,13481,4768,0,2,0,0,1019,19270
2014-01-01,1945,14024,3198,0,1,0,0,655,17878
2014-01-01,1944,15179,2927,0,1,0,0,608,18715
2014-01-01,1943,16453,2619,0,0,0,0,538,19610
2014-01-01,1942,16887,3395,0,0,0,0,734,21016
2014-01-01,1941,16695,4550,0,0,0,0,1051,22296
2014-01-01,1940,15488,4651,0,0,0,0,1171,21310
2014-01-01,1939,14951,4982,0,0,0,0,1243,21176
2014-01-01,1938,14195,4935,0,2,0,0,1209,20341
2014-01-01,1937,12928,5019,0,0,0,0,1278,19225
2014-01-01,1936,12051,3959,0,0,0,0,957,16967
2014-01-01,1935,10942,3354,0,0,0,0,781,15077
2014-01-01,1934,9625,2556,0,0,0,0,606,12787
2014-01-01,1933,9438,2675,0,0,0,0,532,12645
2014-01-01,1932,9121,2857,0,0,0,0,536,12514
2014-01-01,1931,8391,2534,0,1,0,0,554,11480
2014-01-01,1930,7587,2634,0,0,0,0,488,10709
2014-01-01,1929,6576,2186,0,0,0,0,442,9204
2014-01-01,1928,6154,2188,0,0,0,0,387,8729
2014-01-01,1927,5102,1911,0,0,0,0,421,7434
2014-01-01,1926,4080,1571,0,0,0,0,303,5954
2014-01-01,1925,3370,1258,0,0,0,0,262,4890
2014-01-01,1924,2759,1043,0,0,0,0,210,4012
2014-01-01,1923,2268,837,0,0,0,0,156,3261
2014-01-01,1922,1625,601,0,0,0,0,120,2346
2014-01-01,1921,1165,371,0,0,0,0,96,1632
2014-01-01,1920,732,262,0,0,0,0,54,1048
2014-01-01,1919,501,179,0,0,0,0,31,711
2014-01-01,1918,361,149,0,0,0,0,25,535
2014-01-01,1917,209,63,0,0,0,0,8,280
2014-01-01,1916,165,49,0,0,0,0,6,220
2014-01-01,1915,125,63,0,0,0,0,12,200
2014-01-01,1914,132,63,0,0,0,0,5,200
2014-01-01,1913,76,33,0,0,0,0,4,113
2014-01-01,1912,50,11,0,0,0,0,1,62
2014-01-01,1911,40,12,0,0,0,0,0,52
2014-01-01,1910,33,7,0,0,0,0,0,40
2014-01-01,1909,24,4,0,0,0,0,0,28
2014-01-01,1908,14,2,0,0,0,0,0,16
2014-01-01,1907,6,4,0,0,0,0,1,11
2014-01-01,1906,7,2,0,0,0,0,0,9
2014-01-01,1905,5,0,0,0,0,0,0,5
2014-01-01,1904,0,1,0,0,0,0,0,1
2014-01-01,1903,1,1,0,0,0,0,0,2
2014-01-01,1902,1,0,0,0,0,0,0,1
2014-01-01,1898,0,1,0,0,0,0,0,1
